AAAAAACGTAC -> AAAAACGTACC
AAAAACGAAGA -> AAAACGAAGAG
AAAAACGTACC -> AAAACGTACCT
AAAAAGTCAGA -> AAAAGTCAGAT
AAAACGAAGAG -> AAACGAAGAGG
AAAACGGCAGC -> AAACGGCAGCG
AAAACGTACCT -> AAACGTACCTA
AAAAGATTATG -> AAAGATTATGC
AAAAGTCAGAT -> AAAGTCAGATC
AAAATCGCGCG -> AAATCGCGCGT
AAACCACTAGC -> AACCACTAGCT
AAACGAAGAGG -> AACGAAGAGGC
AAACGATTATT -> AACGATTATTG
AAACGGCAGCG -> AACGGCAGCGT
AAACGTACCTA -> AACGTACCTAA
AAACTTTCTAT -> AACTTTCTATC
AAAGATCTCAC -> AAGATCTCACG
AAAGATTATGC -> AAGATTATGCC
AAAGCCGTTGA -> AAGCCGTTGAG
AAAGGACCATC -> AAGGACCATCT
AAAGTATGCTG -> AAGTATGCTGC
AAAGTCAGATC -> AAGTCAGATCG
AAATCAAGTCT -> AATCAAGTCTG
AAATCGCGCGT -> AATCGCGCGTG
AAATCGTGGTC -> AATCGTGGTCA
AAATCTGCATA -> AATCTGCATAC
AAATGTACCTG -> AATGTACCTGT
AAATTATCTTT -> AATTATCTTTT
AAATTATTCGT -> AATTATTCGTG
AAATTGGTCTA -> AATTGGTCTAG
AAATTGTTTTA -> AATTGTTTTAT
AAATTTCAATC -> AATTTCAATCA
AAATTTGACCC -> AATTTGACCCA
AACACAATTGG -> ACACAATTGGA
AACACTCCTGT -> ACACTCCTGTA
AACATACTAGT -> ACATACTAGTC
AACCAATTCCG -> ACCAATTCCGC
AACCACTAGCT -> ACCACTAGCTC
AACCATAAATT -> ACCATAAATTT
AACCGGCTAAG -> ACCGGCTAAGA
AACCTCTACTG -> ACCTCTACTGT
AACCTGGCGGT -> ACCTGGCGGTT
AACCTTCAAAT -> ACCTTCAAATC
AACGAACTCGC -> ACGAACTCGCG
AACGAAGAGGC -> ACGAAGAGGCC
AACGAGGCTGC -> ACGAGGCTGCA
AACGATACATG -> ACGATACATGG
AACGATTATTG -> ACGATTATTGT
AACGCGACCTA -> ACGCGACCTAC
AACGGCAGCGT -> ACGGCAGCGTT
AACGTACCTAA -> ACGTACCTAAT
AACGTGCCCCG -> ACGTGCCCCGA
AACGTTGTGGC -> ACGTTGTGGCG
AACTAAGTTTA -> ACTAAGTTTAG
AACTAGGTAAA -> ACTAGGTAAAT
AACTCGCGAAC -> ACTCGCGAACT
AACTGGAAATT -> ACTGGAAATTG
AACTTCCGTTC -> ACTTCCGTTCG
AACTTTCTATC -> ACTTTCTATCG
AAGAAATTGGT -> AGAAATTGGTC
AAGACGTACCC -> AGACGTACCCT
AAGACTGAACA -> AGACTGAACAC
AAGACTGACCT -> AGACTGACCTC
AAGAGGCCTGT -> AGAGGCCTGTG
AAGATCTCACG -> AGATCTCACGC
AAGATGTGTCT -> AGATGTGTCTA
AAGATTATGCC -> AGATTATGCCC
AAGCCAGCGCC -> AGCCAGCGCCA
AAGCCCTCTCT -> AGCCCTCTCTG
AAGCCGTTGAG -> AGCCGTTGAGT
AAGCGTTCCGA -> AGCGTTCCGAC
AAGCTCTCTTT -> AGCTCTCTTTT
AAGGAACTAAG -> AGGAACTAAGT
AAGGACAGGAT -> AGGACAGGATG
AAGGACCATCT -> AGGACCATCTG
AAGGCACTTGA -> AGGCACTTGAT
AAGGTATGCTA -> AGGTATGCTAT
AAGGTGATGGC -> AGGTGATGGCA
AAGTACGAGGG -> AGTACGAGGGC
AAGTATACTCG -> AGTATACTCGC
AAGTATGCTGC -> AGTATGCTGCA
AAGTCAGATCG -> AGTCAGATCGC
AAGTCTGGCGA -> AGTCTGGCGAT
AAGTTAATTTG -> AGTTAATTTGA
AAGTTTAGCCC -> AGTTTAGCCCA
AATACCAGGCT -> ATACCAGGCTT
AATAGCCGCAT -> ATAGCCGCATG
AATAGTATAGA -> ATAGTATAGAC
AATATTCGGGC -> ATATTCGGGCT
AATCAAGTCTG -> ATCAAGTCTGG
AATCATTGCGT -> ATCATTGCGTG
AATCCCGTCTA -> ATCCCGTCTAA
AATCGCGCGTG -> ATCGCGCGTGG
AATCGGCACAC -> ATCGGCACACT
AATCGTGGTCA -> ATCGTGGTCAG
AATCTGCATAC -> ATCTGCATACT
AATCTGTAAAT -> ATCTGTAAATC
AATGACATGAG -> ATGACATGAGA
AATGCATACAT -> ATGCATACATC
AATGCGTTGTA -> ATGCGTTGTAA
AATGGACGAAA -> ATGGACGAAAG
AATGGATAGTT -> ATGGATAGTTG
AATGGCCCCGG -> ATGGCCCCGGC
AATGGGTTGTG -> ATGGGTTGTGC
AATGTACCTGT -> ATGTACCTGTC
AATGTCGAACT -> ATGTCGAACTT
AATGTCTCTAT -> ATGTCTCTATG
AATGTTGTACC -> ATGTTGTACCT
AATTAATTGGT -> ATTAATTGGTA
AATTATCTTTT -> ATTATCTTTTC
AATTATTCGTG -> ATTATTCGTGC
AATTCATGCAG -> ATTCATGCAGA
AATTCCGCTAG -> ATTCCGCTAGA
AATTCCGGCGG -> ATTCCGGCGGG
AATTGGACCTT -> ATTGGACCTTA
AATTGGTAGAC -> ATTGGTAGACG
AATTGGTCTAG -> ATTGGTCTAGA
AATTGTTTTAT -> ATTGTTTTATA
AATTTAAGCGT -> ATTTAAGCGTT
AATTTCAATCA -> ATTTCAATCAT
AATTTGACCCA -> ATTTGACCCAC
AATTTGACTCG -> ATTTGACTCGG
AATTTGATGCA -> ATTTGATGCAG
ACAAAAACGAA -> CAAAAACGAAG
ACAACACAATT -> CAACACAATTG
ACAAGGAACTA -> CAAGGAACTAA
ACAAGTTAATT -> CAAGTTAATTT
ACAATGCGTTG -> CAATGCGTTGT
ACAATTGGACC -> CAATTGGACCT
ACACAATTGGA -> CACAATTGGAC
ACACACCTCCA -> CACACCTCCAC
ACACACTAAAC -> CACACTAAACG
ACACATAATGC -> CACATAATGCA
ACACCTCCACC -> CACCTCCACCG
ACACTAAACGA -> CACTAAACGAT
ACACTATTTCG -> CACTATTTCGG
ACACTCCTAAC -> CACTCCTAACC
ACACTCCTGTA -> CACTCCTGTAG
ACACTGGCAGG -> CACTGGCAGGC
ACACTTAGTAC -> CACTTAGTACA
ACAGAACGTGC -> CAGAACGTGCC
ACAGACCCGAT -> CAGACCCGATC
ACAGGATGTCT -> CAGGATGTCTA
ACATAATGCAT -> CATAATGCATA
ACATACTAGTC -> CATACTAGTCA
ACATCGCCGAC -> CATCGCCGACG
ACATGAGATCG -> CATGAGATCGT
ACATGCCGACA -> CATGCCGACAC
ACATGGCTGAT -> CATGGCTGATA
ACATTCGTTGT -> CATTCGTTGTA
ACATTTCATGA -> CATTTCATGAT
ACATTTTCAAG -> CATTTTCAAGC
ACCAAGGACAG -> CCAAGGACAGG
ACCAATTCCGC -> CCAATTCCGCT
ACCACTAGCTC -> CCACTAGCTCG
ACCAGGCTTTT -> CCAGGCTTTTG
ACCATAAATTT -> CCATAAATTTG
ACCATCTGGAT -> CCATCTGGATC
ACCCAAGGTAT -> CCCAAGGTATG
ACCCAATTCCG -> CCCAATTCCGG
ACCCACATTTC -> CCCACATTTCA
ACCCCAGTAGA -> CCCCAGTAGAC
ACCCCCTAGCA -> CCCCCTAGCAT
ACCCCCTCGAA -> CCCCCTCGAAC
ACCCGATCGTT -> CCCGATCGTTG
ACCCGGCGCCA -> CCCGGCGCCAT
ACCCTAATAGC -> CCCTAATAGCC
ACCCTAGGGGC -> CCCTAGGGGCT
ACCCTAGTAGT -> CCCTAGTAGTG
ACCGATCTTGG -> CCGATCTTGGG
ACCGCCCGGTC -> CCGCCCGGTCC
ACCGCGTTCAT -> CCGCGTTCATC
ACCGGCTAAGA -> CCGGCTAAGAC
ACCTAACGAGG -> CCTAACGAGGC
ACCTAATGGAT -> CCTAATGGATA
ACCTACCTATC -> CCTACCTATCG
ACCTATCGTAA -> CCTATCGTAAT
ACCTCAAACTT -> CCTCAAACTTT
ACCTCCACCGA -> CCTCCACCGAT
ACCTCGGACCT -> CCTCGGACCTC
ACCTCGTTTCT -> CCTCGTTTCTT
ACCTCTACTGT -> CCTCTACTGTA
ACCTGGCGGTT -> CCTGGCGGTTG
ACCTGTCTCGG -> CCTGTCTCGGG
ACCTTAAGCCC -> CCTTAAGCCCT
ACCTTCAAATC -> CCTTCAAATCT
ACCTTTACGTC -> CCTTTACGTCG
ACGAAAGATCT -> CGAAAGATCTC
ACGAACTCGCG -> CGAACTCGCGA
ACGAAGAGGCC -> CGAAGAGGCCT
ACGACCCCAGT -> CGACCCCAGTA
ACGACGCACCC -> CGACGCACCCC
ACGAGGCTGCA -> CGAGGCTGCAC
ACGAGGGCTAG -> CGAGGGCTAGG
ACGATACATGG -> CGATACATGGC
ACGATTATTGT -> CGATTATTGTA
ACGCACCCCCT -> CGCACCCCCTA
ACGCAGTAAGA -> CGCAGTAAGAC
ACGCCCTTCTC -> CGCCCTTCTCG
ACGCCGATGTT -> CGCCGATGTTT
ACGCCTAATGT -> CGCCTAATGTC
ACGCGACCTAC -> CGCGACCTACC
ACGCTAAGGCA -> CGCTAAGGCAC
ACGCTACTAAG -> CGCTACTAAGA
ACGCTCTGATT -> CGCTCTGATTC
ACGGACGTGAA -> CGGACGTGAAT
ACGGATTCTCA -> CGGATTCTCAC
ACGGCAGCGTT -> CGGCAGCGTTA
ACGTACCCTAG -> CGTACCCTAGT
ACGTACCTAAT -> CGTACCTAATG
ACGTCAGATGC -> CGTCAGATGCC
ACGTCGCGTAG -> CGTCGCGTAGG
ACGTCGTAGTG -> CGTCGTAGTGC
ACGTCTTCATT -> CGTCTTCATTC
ACGTGAATAGT -> CGTGAATAGTA
ACGTGCCCCGA -> CGTGCCCCGAA
ACGTTGTGGCG -> CGTTGTGGCGA
ACTAAACGATT -> CTAAACGATTA
ACTAAGATGTG -> CTAAGATGTGT
ACTAAGTTTAG -> CTAAGTTTAGC
ACTACGTCAGA -> CTACGTCAGAT
ACTAGACTCGG -> CTAGACTCGGG
ACTAGCTCGTA -> CTAGCTCGTAT
ACTAGGTAAAT -> CTAGGTAAATT
ACTAGTCAAGG -> CTAGTCAAGGT
ACTATATCCTA -> CTATATCCTAA
ACTATTTCCTC -> CTATTTCCTCA
ACTATTTCGGT -> CTATTTCGGTC
ACTCCTAACCG -> CTCCTAACCGG
ACTCCTGTAGC -> CTCCTGTAGCA
ACTCGCCATCC -> CTCGCCATCCA
ACTCGCGAACT -> CTCGCGAACTA
ACTCGGGACCC -> CTCGGGACCCT
ACTCGGTAGCA -> CTCGGTAGCAG
ACTCTAACCAA -> CTCTAACCAAT
ACTGAACACTC -> CTGAACACTCC
ACTGACCTCGG -> CTGACCTCGGA
ACTGCTAAAGC -> CTGCTAAAGCC
ACTGCTGAGTC -> CTGCTGAGTCA
ACTGGAAATTG -> CTGGAAATTGT
ACTGGCAAAGG -> CTGGCAAAGGA
ACTGGCAGGCC -> CTGGCAGGCCG
ACTGTAGGACG -> CTGTAGGACGT
ACTTAGTACAG -> CTTAGTACAGA
ACTTATTTTGA -> CTTATTTTGAC
ACTTCCGTTCG -> CTTCCGTTCGG
ACTTCGCTAGT -> CTTCGCTAGTG
ACTTGAAATGT -> CTTGAAATGTA
ACTTGATAATC -> CTTGATAATCG
ACTTGTTGGCA -> CTTGTTGGCAC
ACTTTCTATCG -> CTTTCTATCGG
ACTTTTGTGAG -> CTTTTGTGAGC
AGAAACCACTA -> GAAACCACTAG
AGAAATTGGTC -> GAAATTGGTCT
AGAACGTGCCC -> GAACGTGCCCC
AGAACGTTGTG -> GAACGTTGTGG
AGAAGACGTAC -> GAAGACGTACC
AGACACACCTC -> GACACACCTCC
AGACAGACCCG -> GACAGACCCGA
AGACCAAGGAC -> GACCAAGGACA
AGACCCAATTC -> GACCCAATTCC
AGACCCGATCG -> GACCCGATCGT
AGACGACGCAC -> GACGACGCACC
AGACGCTAAGG -> GACGCTAAGGC
AGACGTACCCT -> GACGTACCCTA
AGACTATTTCC -> GACTATTTCCT
AGACTCGGGAC -> GACTCGGGACC
AGACTGAACAC -> GACTGAACACT
AGACTGACCTC -> GACTGACCTCG
AGAGACGCTAA -> GAGACGCTAAG
AGAGGCCTGTG -> GAGGCCTGTGG
AGAGTAATGGC -> GAGTAATGGCC
AGAGTGTTAAG -> GAGTGTTAAGC
AGATAATTTGA -> GATAATTTGAC
AGATCGCTTTG -> GATCGCTTTGC
AGATCGTCGTT -> GATCGTCGTTT
AGATCTCACGC -> GATCTCACGCT
AGATGCCGTAG -> GATGCCGTAGC
AGATGTGTCTA -> GATGTGTCTAC
AGATGTTATGA -> GATGTTATGAC
AGATTATGCCC -> GATTATGCCCA
AGCAACCATAA -> GCAACCATAAA
AGCAATATTCG -> GCAATATTCGG
AGCACGGATTC -> GCACGGATTCT
AGCAGGTGCGG -> GCAGGTGCGGC
AGCATACCCGG -> GCATACCCGGC
AGCATTGTCTC -> GCATTGTCTCA
AGCCACTGCTG -> GCCACTGCTGA
AGCCAGCGCCA -> GCCAGCGCCAT
AGCCCAGCCGA -> GCCCAGCCGAA
AGCCCAGTGAC -> GCCCAGTGACA
AGCCCCGTGGT -> GCCCCGTGGTT
AGCCCTCTCTG -> GCCCTCTCTGG
AGCCGAACCTG -> GCCGAACCTGG
AGCCGCATGAA -> GCCGCATGAAT
AGCCGCATGCC -> GCCGCATGCCA
AGCCGTTGAGT -> GCCGTTGAGTT
AGCCTTCACGA -> GCCTTCACGAC
AGCGACACTCC -> GCGACACTCCT
AGCGCCATAAA -> GCGCCATAAAT
AGCGTACAAGG -> GCGTACAAGGA
AGCGTATGTCC -> GCGTATGTCCG
AGCGTTATCAG -> GCGTTATCAGA
AGCGTTCCGAC -> GCGTTCCGACA
AGCTCAATACC -> GCTCAATACCA
AGCTCGGGCTA -> GCTCGGGCTAA
AGCTCGTATTA -> GCTCGTATTAT
AGCTCTCTTTT -> GCTCTCTTTTC
AGCTTTGTCTC -> GCTTTGTCTCC
AGGAACATACT -> GGAACATACTA
AGGAACTAAGT -> GGAACTAAGTT
AGGACAGGATG -> GGACAGGATGT
AGGACCATCTG -> GGACCATCTGG
AGGACCGCGTT -> GGACCGCGTTC
AGGACGTCGCG -> GGACGTCGCGT
AGGATGTCTAG -> GGATGTCTAGA
AGGCAAAATCG -> GGCAAAATCGC
AGGCACTTGAT -> GGCACTTGATA
AGGCCGGGTGA -> GGCCGGGTGAC
AGGCCGTATAT -> GGCCGTATATC
AGGCCTGTGGC -> GGCCTGTGGCG
AGGCGCGCAAT -> GGCGCGCAATC
AGGCGTATATT -> GGCGTATATTG
AGGCGTGAGCA -> GGCGTGAGCAC
AGGCTGCACAA -> GGCTGCACAAT
AGGCTTTTGCC -> GGCTTTTGCCC
AGGGCCCCACT -> GGGCCCCACTT
AGGGCTAGGCG -> GGGCTAGGCGT
AGGGGCTGTCG -> GGGGCTGTCGG
AGGTAAATTAT -> GGTAAATTATT
AGGTATGCTAT -> GGTATGCTATT
AGGTGATGGCA -> GGTGATGGCAG
AGGTGCGGCCA -> GGTGCGGCCAC
AGTAACGATAC -> GTAACGATACA
AGTAAGACTGA -> GTAAGACTGAC
AGTAATGGCCC -> GTAATGGCCCC
AGTACAGAACG -> GTACAGAACGT
AGTACGAGGGC -> GTACGAGGGCT
AGTAGACCCAA -> GTAGACCCAAT
AGTAGGACCGC -> GTAGGACCGCG
AGTAGTGCGAT -> GTAGTGCGATT
AGTATACTCGC -> GTATACTCGCC
AGTATAGACCA -> GTATAGACCAA
AGTATGCTGCA -> GTATGCTGCAT
AGTCAAGGTGA -> GTCAAGGTGAT
AGTCAGATCGC -> GTCAGATCGCT
AGTCATCGATA -> GTCATCGATAA
AGTCTGGCGAT -> GTCTGGCGATG
AGTGACAAAAA -> GTGACAAAAAC
AGTGACATGCC -> GTGACATGCCG
AGTGCCCGCAG -> GTGCCCGCAGT
AGTGCGACGGA -> GTGCGACGGAC
AGTGCGATTCC -> GTGCGATTCCA
AGTGTTAAGCC -> GTGTTAAGCCA
AGTTAATTTGA -> GTTAATTTGAT
AGTTAGCGACA -> GTTAGCGACAC
AGTTCAGCTTT -> GTTCAGCTTTG
AGTTCATTCTG -> GTTCATTCTGG
AGTTGAGCCCC -> GTTGAGCCCCG
AGTTGTCTCAA -> GTTGTCTCAAG
AGTTTAGCCCA -> GTTTAGCCCAG
ATAAATCAAGT -> TAAATCAAGTC
ATAAATTTGAC -> TAAATTTGACC
ATAAGTATACT -> TAAGTATACTC
ATAATCGGCAC -> TAATCGGCACA
ATAATGCATAC -> TAATGCATACA
ATAATGGACGA -> TAATGGACGAA
ATAATTTGACT -> TAATTTGACTC
ATACACATAAT -> TACACATAATG
ATACATCGCCG -> TACATCGCCGA
ATACATGGCTG -> TACATGGCTGA
ATACCAGGCTT -> TACCAGGCTTT
ATACCCCCTCG -> TACCCCCTCGA
ATACCCGGCGC -> TACCCGGCGCC
ATACTAGTCAA -> TACTAGTCAAG
ATACTATATCC -> TACTATATCCT
ATACTCGCCAT -> TACTCGCCATC
ATACTGCTAAA -> TACTGCTAAAG
ATAGACCAAGG -> TAGACCAAGGA
ATAGCCGCATG -> TAGCCGCATGA
ATAGGCGCGCA -> TAGGCGCGCAA
ATAGGGCCCCA -> TAGGGCCCCAC
ATAGTATAGAC -> TAGTATAGACC
ATAGTTGAGCC -> TAGTTGAGCCC
ATATCCTAACG -> TATCCTAACGC
ATATCTACCTA -> TATCTACCTAA
ATATTCGGGCT -> TATTCGGGCTG
ATATTGATCCA -> TATTGATCCAA
ATCAAGTCTGG -> TCAAGTCTGGC
ATCACGCTACT -> TCACGCTACTA
ATCAGATGTTA -> TCAGATGTTAT
ATCAGCGTATG -> TCAGCGTATGT
ATCATTGCGTG -> TCATTGCGTGG
ATCCAAAGTAT -> TCCAAAGTATG
ATCCACACTGG -> TCCACACTGGC
ATCCATTGGAA -> TCCATTGGAAT
ATCCCCGTGAG -> TCCCCGTGAGT
ATCCCGTCTAA -> TCCCGTCTAAA
ATCCTAACGCG -> TCCTAACGCGA
ATCGATAATGG -> TCGATAATGGA
ATCGCCGACGC -> TCGCCGACGCC
ATCGCGCGTGG -> TCGCGCGTGGT
ATCGCTTTGCT -> TCGCTTTGCTA
ATCGGACTACG -> TCGGACTACGT
ATCGGCACACT -> TCGGCACACTA
ATCGTAATTTA -> TCGTAATTTAA
ATCGTCGTTTA -> TCGTCGTTTAG
ATCGTGGTCAG -> TCGTGGTCAGC
ATCGTTGAAAT -> TCGTTGAAATT
ATCTACAAGTT -> TCTACAAGTTA
ATCTACCTAAC -> TCTACCTAACG
ATCTCACGCTC -> TCTCACGCTCT
ATCTCACTTTT -> TCTCACTTTTG
ATCTGCATACT -> TCTGCATACTA
ATCTGGATCCA -> TCTGGATCCAT
ATCTGTAAATC -> TCTGTAAATCG
ATCTTGGGCTA -> TCTTGGGCTAC
ATCTTTTCTGG -> TCTTTTCTGGA
ATGAATTAATT -> TGAATTAATTG
ATGACATGAGA -> TGACATGAGAT
ATGACGCCTAA -> TGACGCCTAAT
ATGAGATCGTC -> TGAGATCGTCG
ATGATAGGCGC -> TGATAGGCGCG
ATGATGCCGCA -> TGATGCCGCAT
ATGCAGAACGT -> TGCAGAACGTT
ATGCAGTTCAT -> TGCAGTTCATT
ATGCATACATC -> TGCATACATCG
ATGCCAGAAGA -> TGCCAGAAGAC
ATGCCCATCAG -> TGCCCATCAGC
ATGCCGACACT -> TGCCGACACTT
ATGCCGCATGT -> TGCCGCATGTT
ATGCCGTAGCC -> TGCCGTAGCCA
ATGCGTTGTAA -> TGCGTTGTAAA
ATGCTATTCAC -> TGCTATTCACT
ATGCTGCATAC -> TGCTGCATACC
ATGGACCCAAG -> TGGACCCAAGG
ATGGACGAAAG -> TGGACGAAAGA
ATGGATAGTTG -> TGGATAGTTGA
ATGGCAGAGAC -> TGGCAGAGACG
ATGGCCCCGGC -> TGGCCCCGGCT
ATGGCTGATAC -> TGGCTGATACA
ATGGGATCTCA -> TGGGATCTCAC
ATGGGTTGTGC -> TGGGTTGTGCA
ATGTACCTGTC -> TGTACCTGTCT
ATGTCCGAGCG -> TGTCCGAGCGT
ATGTCGAACTT -> TGTCGAACTTC
ATGTCTAGACA -> TGTCTAGACAG
ATGTCTCTATG -> TGTCTCTATGG
ATGTCTGTATG -> TGTCTGTATGA
ATGTGTCTACT -> TGTGTCTACTT
ATGTTATGACG -> TGTTATGACGC
ATGTTCCCAGC -> TGTTCCCAGCA
ATGTTGTACCT -> TGTTGTACCTT
ATGTTTGAGTA -> TGTTTGAGTAG
ATGTTTTGCCA -> TGTTTTGCCAA
ATTAATTGGTA -> TTAATTGGTAG
ATTATCTTTTC -> TTATCTTTTCT
ATTATGCCCAT -> TTATGCCCATC
ATTATGGGATC -> TTATGGGATCT
ATTATTCGTGC -> TTATTCGTGCG
ATTATTGTAGG -> TTATTGTAGGC
ATTCACTCTAA -> TTCACTCTAAC
ATTCAGCCGCA -> TTCAGCCGCAT
ATTCAGTAACG -> TTCAGTAACGA
ATTCATGCAGA -> TTCATGCAGAA
ATTCCATTCAG -> TTCCATTCAGT
ATTCCGCTAGA -> TTCCGCTAGAG
ATTCCGGCAGA -> TTCCGGCAGAA
ATTCCGGCGGG -> TTCCGGCGGGG
ATTCGGGCTGG -> TTCGGGCTGGA
ATTCGTGCGGA -> TTCGTGCGGAC
ATTCGTTGTAA -> TTCGTTGTAAT
ATTCTCACTAG -> TTCTCACTAGA
ATTCTGGTCAG -> TTCTGGTCAGT
ATTGATCCAAA -> TTGATCCAAAG
ATTGCGTGGCC -> TTGCGTGGCCG
ATTGGAATGTC -> TTGGAATGTCT
ATTGGACCTTA -> TTGGACCTTAA
ATTGGTAGACG -> TTGGTAGACGA
ATTGGTCTAGA -> TTGGTCTAGAG
ATTGTAGGCCG -> TTGTAGGCCGG
ATTGTCTCACT -> TTGTCTCACTT
ATTGTTTTATA -> TTGTTTTATAA
ATTTAAGCGTT -> TTTAAGCGTTC
ATTTCAATCAT -> TTTCAATCATT
ATTTCATGATG -> TTTCATGATGC
ATTTCCTCAGC -> TTTCCTCAGCT
ATTTCCTTTGG -> TTTCCTTTGGG
ATTTCGGTCCG -> TTTCGGTCCGC
ATTTGACCCAC -> TTTGACCCACA
ATTTGACTCGG -> TTTGACTCGGT
ATTTGATGCAG -> TTTGATGCAGT
ATTTTCAAGCT -> TTTTCAAGCTC
ATTTTGACATT -> TTTTGACATTT
CAAAAACGAAG -> AAAAACGAAGA
CAAAAAGTCAG -> AAAAAGTCAGA
CAAAATCGCGC -> AAAATCGCGCG
CAAACTTTCTA -> AAACTTTCTAT
CAAAGGACCAT -> AAAGGACCATC
CAAAGTATGCT -> AAAGTATGCTG
CAAATCTGCAT -> AAATCTGCATA
CAACACAATTG -> AACACAATTGG
CAACCATAAAT -> AACCATAAATT
CAAGCTCTCTT -> AAGCTCTCTTT
CAAGGAACTAA -> AAGGAACTAAG
CAAGGACAGGA -> AAGGACAGGAT
CAAGGTATGCT -> AAGGTATGCTA
CAAGGTGATGG -> AAGGTGATGGC
CAAGTACGAGG -> AAGTACGAGGG
CAAGTCTGGCG -> AAGTCTGGCGA
CAAGTTAATTT -> AAGTTAATTTG
CAATACCAGGC -> AATACCAGGCT
CAATATTCGGG -> AATATTCGGGC
CAATCATTGCG -> AATCATTGCGT
CAATCTGTAAA -> AATCTGTAAAT
CAATGCGTTGT -> AATGCGTTGTA
CAATTCATGCA -> AATTCATGCAG
CAATTCCGCTA -> AATTCCGCTAG
CAATTCCGGCG -> AATTCCGGCGG
CAATTGGACCT -> AATTGGACCTT
CACAATGCGTT -> ACAATGCGTTG
CACAATTGGAC -> ACAATTGGACC
CACACCTCCAC -> ACACCTCCACC
CACACTAAACG -> ACACTAAACGA
CACACTATTTC -> ACACTATTTCG
CACACTGGCAG -> ACACTGGCAGG
CACATAATGCA -> ACATAATGCAT
CACATTTCATG -> ACATTTCATGA
CACCCCCTAGC -> ACCCCCTAGCA
CACCCTAATAG -> ACCCTAATAGC
CACCGATCTTG -> ACCGATCTTGG
CACCTCCACCG -> ACCTCCACCGA
CACGACCCCAG -> ACGACCCCAGT
CACGCTACTAA -> ACGCTACTAAG
CACGCTCTGAT -> ACGCTCTGATT
CACGGATTCTC -> ACGGATTCTCA
CACGTCTTCAT -> ACGTCTTCATT
CACTAAACGAT -> ACTAAACGATT
CACTAGACTCG -> ACTAGACTCGG
CACTAGCTCGT -> ACTAGCTCGTA
CACTATTTCGG -> ACTATTTCGGT
CACTCCTAACC -> ACTCCTAACCG
CACTCCTGTAG -> ACTCCTGTAGC
CACTCTAACCA -> ACTCTAACCAA
CACTGCTGAGT -> ACTGCTGAGTC
CACTGGCAGGC -> ACTGGCAGGCC
CACTTAGTACA -> ACTTAGTACAG
CACTTCGCTAG -> ACTTCGCTAGT
CACTTGAAATG -> ACTTGAAATGT
CACTTGATAAT -> ACTTGATAATC
CACTTGTTGGC -> ACTTGTTGGCA
CACTTTTGTGA -> ACTTTTGTGAG
CAGAAACCACT -> AGAAACCACTA
CAGAACGTGCC -> AGAACGTGCCC
CAGAACGTTGT -> AGAACGTTGTG
CAGAAGACGTA -> AGAAGACGTAC
CAGACCCGATC -> AGACCCGATCG
CAGAGACGCTA -> AGAGACGCTAA
CAGATCGCTTT -> AGATCGCTTTG
CAGATGCCGTA -> AGATGCCGTAG
CAGATGTTATG -> AGATGTTATGA
CAGCAATATTC -> AGCAATATTCG
CAGCCGAACCT -> AGCCGAACCTG
CAGCCGCATGC -> AGCCGCATGCC
CAGCCTTCACG -> AGCCTTCACGA
CAGCGCCATAA -> AGCGCCATAAA
CAGCGTATGTC -> AGCGTATGTCC
CAGCGTTATCA -> AGCGTTATCAG
CAGCTCAATAC -> AGCTCAATACC
CAGCTCGGGCT -> AGCTCGGGCTA
CAGCTTTGTCT -> AGCTTTGTCTC
CAGGAACATAC -> AGGAACATACT
CAGGATGTCTA -> AGGATGTCTAG
CAGGCCGTATA -> AGGCCGTATAT
CAGGCGTATAT -> AGGCGTATATT
CAGGCTTTTGC -> AGGCTTTTGCC
CAGGTGCGGCC -> AGGTGCGGCCA
CAGTAACGATA -> AGTAACGATAC
CAGTAAGACTG -> AGTAAGACTGA
CAGTAGACCCA -> AGTAGACCCAA
CAGTGACAAAA -> AGTGACAAAAA
CAGTGCGACGG -> AGTGCGACGGA
CAGTTAGCGAC -> AGTTAGCGACA
CAGTTCATTCT -> AGTTCATTCTG
CATAAATCAAG -> ATAAATCAAGT
CATAAATTTGA -> ATAAATTTGAC
CATAATGCATA -> ATAATGCATAC
CATACATCGCC -> ATACATCGCCG
CATACCCCCTC -> ATACCCCCTCG
CATACCCGGCG -> ATACCCGGCGC
CATACTAGTCA -> ATACTAGTCAA
CATACTATATC -> ATACTATATCC
CATCACGCTAC -> ATCACGCTACT
CATCAGCGTAT -> ATCAGCGTATG
CATCCACACTG -> ATCCACACTGG
CATCCCCGTGA -> ATCCCCGTGAG
CATCGATAATG -> ATCGATAATGG
CATCGCCGACG -> ATCGCCGACGC
CATCTACAAGT -> ATCTACAAGTT
CATCTGGATCC -> ATCTGGATCCA
CATGAATTAAT -> ATGAATTAATT
CATGAGATCGT -> ATGAGATCGTC
CATGATGCCGC -> ATGATGCCGCA
CATGCAGAACG -> ATGCAGAACGT
CATGCCAGAAG -> ATGCCAGAAGA
CATGCCGACAC -> ATGCCGACACT
CATGGCTGATA -> ATGGCTGATAC
CATGTTTTGCC -> ATGTTTTGCCA
CATTCAGTAAC -> ATTCAGTAACG
CATTCCGGCAG -> ATTCCGGCAGA
CATTCGTTGTA -> ATTCGTTGTAA
CATTCTGGTCA -> ATTCTGGTCAG
CATTGCGTGGC -> ATTGCGTGGCC
CATTGGAATGT -> ATTGGAATGTC
CATTGTCTCAC -> ATTGTCTCACT
CATTTCATGAT -> ATTTCATGATG
CATTTCCTTTG -> ATTTCCTTTGG
CATTTTCAAGC -> ATTTTCAAGCT
CCAAAGTATGC -> CAAAGTATGCT
CCAAGGACAGG -> CAAGGACAGGA
CCAAGGTATGC -> CAAGGTATGCT
CCAATTCATGC -> CAATTCATGCA
CCAATTCCGCT -> CAATTCCGCTA
CCAATTCCGGC -> CAATTCCGGCG
CCACACTGGCA -> CACACTGGCAG
CCACATTTCAT -> CACATTTCATG
CCACCCTAATA -> CACCCTAATAG
CCACCGATCTT -> CACCGATCTTG
CCACTAGCTCG -> CACTAGCTCGT
CCACTGCTGAG -> CACTGCTGAGT
CCACTTCGCTA -> CACTTCGCTAG
CCAGAAGACGT -> CAGAAGACGTA
CCAGCAATATT -> CAGCAATATTC
CCAGCCGAACC -> CAGCCGAACCT
CCAGCCTTCAC -> CAGCCTTCACG
CCAGCGCCATA -> CAGCGCCATAA
CCAGGCTTTTG -> CAGGCTTTTGC
CCAGTAGACCC -> CAGTAGACCCA
CCAGTGACAAA -> CAGTGACAAAA
CCATAAATCAA -> CATAAATCAAG
CCATAAATTTG -> CATAAATTTGA
CCATCAGCGTA -> CATCAGCGTAT
CCATCCACACT -> CATCCACACTG
CCATCTGGATC -> CATCTGGATCC
CCATTCAGTAA -> CATTCAGTAAC
CCATTGGAATG -> CATTGGAATGT
CCATTTCCTTT -> CATTTCCTTTG
CCCAAGGTATG -> CCAAGGTATGC
CCCAATTCCGG -> CCAATTCCGGC
CCCACATTTCA -> CCACATTTCAT
CCCACTTCGCT -> CCACTTCGCTA
CCCAGCAATAT -> CCAGCAATATT
CCCAGCCGAAC -> CCAGCCGAACC
CCCAGTAGACC -> CCAGTAGACCC
CCCAGTGACAA -> CCAGTGACAAA
CCCATCAGCGT -> CCATCAGCGTA
CCCCACTTCGC -> CCCACTTCGCT
CCCCAGTAGAC -> CCCAGTAGACC
CCCCCTAGCAT -> CCCCTAGCATA
CCCCCTCGAAC -> CCCCTCGAACG
CCCCGAATGTT -> CCCGAATGTTG
CCCCGGCTCAG -> CCCGGCTCAGG
CCCCGTGAGTT -> CCCGTGAGTTG
CCCCGTGGTTT -> CCCGTGGTTTC
CCCCTAGCATA -> CCCTAGCATAC
CCCCTCGAACG -> CCCTCGAACGA
CCCGAATGTTG -> CCGAATGTTGT
CCCGATCGTTG -> CCGATCGTTGA
CCCGCAGTTAG -> CCGCAGTTAGC
CCCGCCGTAAC -> CCGCCGTAACC
CCCGGCGCCAT -> CCGGCGCCATT
CCCGGCTCAGG -> CCGGCTCAGGA
CCCGGTCCTGA -> CCGGTCCTGAA
CCCGTCTAAAA -> CCGTCTAAAAG
CCCGTGAGTTG -> CCGTGAGTTGT
CCCGTGGTTTC -> CCGTGGTTTCA
CCCTAATAGCC -> CCTAATAGCCG
CCCTAGCATAC -> CCTAGCATACC
CCCTAGGGGCT -> CCTAGGGGCTG
CCCTAGTAGTG -> CCTAGTAGTGC
CCCTCGAACGA -> CCTCGAACGAA
CCCTCTCTGGT -> CCTCTCTGGTA
CCCTGCATCCC -> CCTGCATCCCC
CCCTTCTCGGA -> CCTTCTCGGAA
CCGAACCTGGC -> CGAACCTGGCG
CCGAATGTTGT -> CGAATGTTGTA
CCGACACACTA -> CGACACACTAA
CCGACACTTAG -> CGACACTTAGT
CCGACATTCGT -> CGACATTCGTT
CCGACGCCGAT -> CGACGCCGATG
CCGATCGTTGA -> CGATCGTTGAA
CCGATCTTGGG -> CGATCTTGGGC
CCGATGTTTGA -> CGATGTTTGAG
CCGCAGTTAGC -> CGCAGTTAGCG
CCGCATGAATT -> CGCATGAATTA
CCGCATGCCAG -> CGCATGCCAGA
CCGCATGTTTT -> CGCATGTTTTG
CCGCCCGGTCC -> CGCCCGGTCCT
CCGCCGTAACC -> CGCCGTAACCT
CCGCGTTCATC -> CGCGTTCATCA
CCGCTAGAGTG -> CGCTAGAGTGT
CCGCTTACCGC -> CGCTTACCGCC
CCGGCAGAAAC -> CGGCAGAAACC
CCGGCGCCATT -> CGGCGCCATTT
CCGGCGGGGCA -> CGGCGGGGCAA
CCGGCTAAGAC -> CGGCTAAGACT
CCGGCTCAGGA -> CGGCTCAGGAA
CCGGGTGACTG -> CGGGTGACTGG
CCGGTCCTGAA -> CGGTCCTGAAA
CCGTAACCTCT -> CGTAACCTCTA
CCGTAGCCACT -> CGTAGCCACTG
CCGTATATCTA -> CGTATATCTAC
CCGTCTAAAAG -> CGTCTAAAAGA
CCGTGAGTTGT -> CGTGAGTTGTC
CCGTGGTTTCA -> CGTGGTTTCAC
CCGTTCGGGAT -> CGTTCGGGATA
CCGTTGAGTTC -> CGTTGAGTTCA
CCTAACCGGCT -> CTAACCGGCTA
CCTAACGAGGC -> CTAACGAGGCT
CCTAACGCGAC -> CTAACGCGACC
CCTAATAGCCG -> CTAATAGCCGC
CCTAATGGATA -> CTAATGGATAG
CCTAATGTCGA -> CTAATGTCGAA
CCTACCTATCG -> CTACCTATCGT
CCTAGCATACC -> CTAGCATACCC
CCTAGGGGCTG -> CTAGGGGCTGT
CCTAGTAGTGC -> CTAGTAGTGCG
CCTATCGTAAT -> CTATCGTAATT
CCTCAAACTTT -> CTCAAACTTTC
CCTCAGCTCGG -> CTCAGCTCGGG
CCTCCACCGAT -> CTCCACCGATC
CCTCGAACGAA -> CTCGAACGAAC
CCTCGGACCTC -> CTCGGACCTCG
CCTCGTTTCTT -> CTCGTTTCTTT
CCTCTACTGTA -> CTCTACTGTAG
CCTCTCTGGTA -> CTCTCTGGTAA
CCTGAAAAAAC -> CTGAAAAAACG
CCTGCATCCCC -> CTGCATCCCCG
CCTGGCGGTTG -> CTGGCGGTTGA
CCTGTAGCAAC -> CTGTAGCAACC
CCTGTCTCGGG -> CTGTCTCGGGA
CCTGTGGCGCC -> CTGTGGCGCCA
CCTTAAGCCCT -> CTTAAGCCCTC
CCTTCAAATCT -> CTTCAAATCTG
CCTTCACGACC -> CTTCACGACCC
CCTTCTCGGAA -> CTTCTCGGAAC
CCTTTACGTCG -> CTTTACGTCGT
CCTTTGGGGAA -> CTTTGGGGAAG
CGAAAGATCTC -> GAAAGATCTCA
CGAACCTGGCG -> GAACCTGGCGG
CGAACGAACTC -> GAACGAACTCG
CGAACTAGGTA -> GAACTAGGTAA
CGAACTCGCGA -> GAACTCGCGAA
CGAACTTCCGT -> GAACTTCCGTT
CGAAGAGGCCT -> GAAGAGGCCTG
CGAATGTTGTA -> GAATGTTGTAC
CGACACACTAA -> GACACACTAAA
CGACACTCCTA -> GACACTCCTAA
CGACACTTAGT -> GACACTTAGTA
CGACATTCGTT -> GACATTCGTTG
CGACCCCAGTA -> GACCCCAGTAG
CGACCTACCTA -> GACCTACCTAT
CGACGCACCCC -> GACGCACCCCC
CGACGCAGTAA -> GACGCAGTAAG
CGACGCCGATG -> GACGCCGATGT
CGACGGACGTG -> GACGGACGTGA
CGAGGCTGCAC -> GAGGCTGCACA
CGAGGGCTAGG -> GAGGGCTAGGC
CGATAATGGAC -> GATAATGGACG
CGATACATGGC -> GATACATGGCT
CGATCGTTGAA -> GATCGTTGAAA
CGATCTTGGGC -> GATCTTGGGCT
CGATGTTCCCA -> GATGTTCCCAG
CGATGTTTGAG -> GATGTTTGAGT
CGATTATTGTA -> GATTATTGTAG
CGATTCCATTC -> GATTCCATTCA
CGCAATCTGTA -> GCAATCTGTAA
CGCACCCCCTA -> GCACCCCCTAG
CGCAGTAAGAC -> GCAGTAAGACT
CGCAGTTAGCG -> GCAGTTAGCGA
CGCATGAATTA -> GCATGAATTAA
CGCATGCCAGA -> GCATGCCAGAA
CGCATGTTTTG -> GCATGTTTTGC
CGCCAGCCTTC -> GCCAGCCTTCA
CGCCATAAATC -> GCCATAAATCA
CGCCATCCACA -> GCCATCCACAC
CGCCATTTCCT -> GCCATTTCCTT
CGCCCGGTCCT -> GCCCGGTCCTG
CGCCCTTCTCG -> GCCCTTCTCGG
CGCCGACGCCG -> GCCGACGCCGA
CGCCGATGTTT -> GCCGATGTTTG
CGCCGTAACCT -> GCCGTAACCTC
CGCCTAATGTC -> GCCTAATGTCG
CGCGAACTAGG -> GCGAACTAGGT
CGCGACCTACC -> GCGACCTACCT
CGCGCAATCTG -> GCGCAATCTGT
CGCGCGTGGTT -> GCGCGTGGTTA
CGCGTAGGCAA -> GCGTAGGCAAA
CGCGTGGTTAG -> GCGTGGTTAGC
CGCGTTCATCA -> GCGTTCATCAC
CGCTAAGGCAC -> GCTAAGGCACT
CGCTACTAAGA -> GCTACTAAGAT
CGCTAGAGTGT -> GCTAGAGTGTT
CGCTAGTGACA -> GCTAGTGACAT
CGCTCTGATTC -> GCTCTGATTCA
CGCTTACCGCC -> GCTTACCGCCC
CGCTTTGCTAC -> GCTTTGCTACA
CGGAACTGGAA -> GGAACTGGAAA
CGGACCTCGTT -> GGACCTCGTTT
CGGACGCCCTT -> GGACGCCCTTC
CGGACGTGAAT -> GGACGTGAATA
CGGACTACGTC -> GGACTACGTCA
CGGATGTCTGT -> GGATGTCTGTA
CGGATTCTCAC -> GGATTCTCACT
CGGCACACTAT -> GGCACACTATT
CGGCAGAAACC -> GGCAGAAACCA
CGGCAGCGTTA -> GGCAGCGTTAT
CGGCCACCCTA -> GGCCACCCTAA
CGGCGCCATTT -> GGCGCCATTTC
CGGCGGGGCAA -> GGCGGGGCAAA
CGGCTAAGACT -> GGCTAAGACTG
CGGCTCAGGAA -> GGCTCAGGAAC
CGGGACCCTAG -> GGGACCCTAGG
CGGGAGACACA -> GGGAGACACAC
CGGGATAGGGC -> GGGATAGGGCC
CGGGCTAAATT -> GGGCTAAATTA
CGGGCTGGAAT -> GGGCTGGAATG
CGGGGCAAAAA -> GGGGCAAAAAG
CGGGTGACTGG -> GGGTGACTGGC
CGGTAGCAGGT -> GGTAGCAGGTG
CGGTCCGCTTA -> GGTCCGCTTAC
CGGTCCTGAAA -> GGTCCTGAAAA
CGGTTGAGATA -> GGTTGAGATAA
CGTAACCTCTA -> GTAACCTCTAC
CGTAATTTAAG -> GTAATTTAAGC
CGTACAAGGAA -> GTACAAGGAAC
CGTACCCTAGT -> GTACCCTAGTA
CGTACCTAATG -> GTACCTAATGG
CGTAGCCACTG -> GTAGCCACTGC
CGTAGGCAAAA -> GTAGGCAAAAT
CGTAGTGCCCG -> GTAGTGCCCGC
CGTATATCTAC -> GTATATCTACC
CGTATATTGAT -> GTATATTGATC
CGTATGTCCGA -> GTATGTCCGAG
CGTATTATGGG -> GTATTATGGGA
CGTCAGATGCC -> GTCAGATGCCG
CGTCGCGTAGG -> GTCGCGTAGGC
CGTCGTAGTGC -> GTCGTAGTGCC
CGTCGTTTAGC -> GTCGTTTAGCC
CGTCTAAAAGA -> GTCTAAAAGAT
CGTCTTCATTC -> GTCTTCATTCC
CGTGAATAGTA -> GTGAATAGTAT
CGTGAGCACGG -> GTGAGCACGGA
CGTGAGTTGTC -> GTGAGTTGTCT
CGTGCCCCGAA -> GTGCCCCGAAT
CGTGCGGACGC -> GTGCGGACGCC
CGTGGCCGACA -> GTGGCCGACAC
CGTGGTCAGCT -> GTGGTCAGCTC
CGTGGTTAGCA -> GTGGTTAGCAT
CGTGGTTTCAC -> GTGGTTTCACT
CGTTATCAGAT -> GTTATCAGATG
CGTTCATCACG -> GTTCATCACGC
CGTTCATCTAC -> GTTCATCTACA
CGTTCCGACAT -> GTTCCGACATT
CGTTCGGGATA -> GTTCGGGATAG
CGTTGAAATTT -> GTTGAAATTTC
CGTTGAGTTCA -> GTTGAGTTCAG
CGTTGTAAAAC -> GTTGTAAAACG
CGTTGTAATCC -> GTTGTAATCCC
CGTTGTGGCGA -> GTTGTGGCGAC
CGTTTAGCCCA -> GTTTAGCCCAG
CGTTTCTTTTA -> GTTTCTTTTAG
CTAAAAGATTA -> TAAAAGATTAT
CTAAACGATTA -> TAAACGATTAT
CTAAAGCCGTT -> TAAAGCCGTTG
CTAAATTATCT -> TAAATTATCTT
CTAACCAATTC -> TAACCAATTCC
CTAACCGGCTA -> TAACCGGCTAA
CTAACGAGGCT -> TAACGAGGCTG
CTAACGCGACC -> TAACGCGACCT
CTAAGACTGAA -> TAAGACTGAAC
CTAAGATGTGT -> TAAGATGTGTC
CTAAGGCACTT -> TAAGGCACTTG
CTAAGTTTAGC -> TAAGTTTAGCC
CTAATAGCCGC -> TAATAGCCGCA
CTAATGGATAG -> TAATGGATAGT
CTAATGTCGAA -> TAATGTCGAAC
CTACAACACAA -> TACAACACAAT
CTACAAGTTAA -> TACAAGTTAAT
CTACCTAACGA -> TACCTAACGAG
CTACCTATCGT -> TACCTATCGTA
CTACCTCAAAC -> TACCTCAAACT
CTACGTCAGAT -> TACGTCAGATG
CTACTAAGATG -> TACTAAGATGT
CTACTGTAGGA -> TACTGTAGGAC
CTACTTATTTT -> TACTTATTTTG
CTAGACAGACC -> TAGACAGACCC
CTAGACTCGGG -> TAGACTCGGGA
CTAGAGTAATG -> TAGAGTAATGG
CTAGAGTGTTA -> TAGAGTGTTAA
CTAGCATACCC -> TAGCATACCCG
CTAGCTCGTAT -> TAGCTCGTATT
CTAGGCGTGAG -> TAGGCGTGAGC
CTAGGGGCTGT -> TAGGGGCTGTC
CTAGGTAAATT -> TAGGTAAATTA
CTAGTAGTGCG -> TAGTAGTGCGA
CTAGTCAAGGT -> TAGTCAAGGTG
CTAGTGACATG -> TAGTGACATGC
CTATATCCTAA -> TATATCCTAAC
CTATCGGACTA -> TATCGGACTAC
CTATCGTAATT -> TATCGTAATTT
CTATGGACCCA -> TATGGACCCAA
CTATTCACTCT -> TATTCACTCTA
CTATTTCCTCA -> TATTTCCTCAG
CTATTTCGGTC -> TATTTCGGTCC
CTCAAACTTTC -> TCAAACTTTCT
CTCAAGTACGA -> TCAAGTACGAG
CTCAATACCAG -> TCAATACCAGG
CTCACGCTCTG -> TCACGCTCTGA
CTCACTAGACT -> TCACTAGACTC
CTCACTTGTTG -> TCACTTGTTGG
CTCACTTTTGT -> TCACTTTTGTG
CTCAGCTCGGG -> TCAGCTCGGGC
CTCAGGAACAT -> TCAGGAACATA
CTCCACCGATC -> TCCACCGATCT
CTCCCTGCATC -> TCCCTGCATCC
CTCCTAACCGG -> TCCTAACCGGC
CTCCTGTAGCA -> TCCTGTAGCAA
CTCGAACGAAC -> TCGAACGAACT
CTCGCCATCCA -> TCGCCATCCAC
CTCGCGAACTA -> TCGCGAACTAG
CTCGGAACTGG -> TCGGAACTGGA
CTCGGACCTCG -> TCGGACCTCGT
CTCGGGACCCT -> TCGGGACCCTA
CTCGGGAGACA -> TCGGGAGACAC
CTCGGGCTAAA -> TCGGGCTAAAT
CTCGGTAGCAG -> TCGGTAGCAGG
CTCGTATTATG -> TCGTATTATGG
CTCGTTTCTTT -> TCGTTTCTTTT
CTCTAACCAAT -> TCTAACCAATT
CTCTACTGTAG -> TCTACTGTAGG
CTCTATGGACC -> TCTATGGACCC
CTCTCTGGTAA -> TCTCTGGTAAC
CTCTCTTTTCG -> TCTCTTTTCGT
CTCTGATTCAG -> TCTGATTCAGC
CTCTGGTAACC -> TCTGGTAACCT
CTCTTTTCGTT -> TCTTTTCGTTC
CTGAAAAAACG -> TGAAAAAACGT
CTGAACACTCC -> TGAACACTCCT
CTGACCTCGGA -> TGACCTCGGAC
CTGAGTCATCG -> TGAGTCATCGA
CTGATACACAT -> TGATACACATA
CTGATTCAGCC -> TGATTCAGCCG
CTGCACAATGC -> TGCACAATGCG
CTGCATACCCC -> TGCATACCCCC
CTGCATACTAT -> TGCATACTATA
CTGCATCCCCG -> TGCATCCCCGT
CTGCTAAAGCC -> TGCTAAAGCCG
CTGCTGAGTCA -> TGCTGAGTCAT
CTGGAAATTGT -> TGGAAATTGTT
CTGGAATGGGT -> TGGAATGGGTT
CTGGATACTGC -> TGGATACTGCT
CTGGATCCATT -> TGGATCCATTG
CTGGCAAAGGA -> TGGCAAAGGAC
CTGGCAGGCCG -> TGGCAGGCCGT
CTGGCGATGTT -> TGGCGATGTTC
CTGGCGGTTGA -> TGGCGGTTGAG
CTGGTAACCTT -> TGGTAACCTTC
CTGGTCAGTGC -> TGGTCAGTGCG
CTGTAAATCGT -> TGTAAATCGTG
CTGTAGCAACC -> TGTAGCAACCA
CTGTAGGACGT -> TGTAGGACGTC
CTGTATGATAG -> TGTATGATAGG
CTGTCGGATGT -> TGTCGGATGTC
CTGTCTCGGGA -> TGTCTCGGGAG
CTGTGGCGCCA -> TGTGGCGCCAG
CTTAAGCCCTC -> TTAAGCCCTCT
CTTACCGCCCG -> TTACCGCCCGG
CTTAGTACAGA -> TTAGTACAGAA
CTTATTTTGAC -> TTATTTTGACA
CTTCAAATCTG -> TTCAAATCTGC
CTTCACGACCC -> TTCACGACCCC
CTTCATTCCGG -> TTCATTCCGGC
CTTCCGTTCGG -> TTCCGTTCGGG
CTTCGCTAGTG -> TTCGCTAGTGA
CTTCTCGGAAC -> TTCTCGGAACT
CTTGAAATGTA -> TTGAAATGTAC
CTTGATAATCG -> TTGATAATCGG
CTTGGGCTACC -> TTGGGCTACCT
CTTGTTGGCAC -> TTGTTGGCACG
CTTTACGTCGT -> TTTACGTCGTA
CTTTCTATCGG -> TTTCTATCGGA
CTTTGCTACAA -> TTTGCTACAAC
CTTTGGGGAAG -> TTTGGGGAAGA
CTTTGTCTCCC -> TTTGTCTCCCT
CTTTTAGACTA -> TTTTAGACTAT
CTTTTCGTTCA -> TTTTCGTTCAT
CTTTTCTGGAT -> TTTTCTGGATA
CTTTTGCCCGC -> TTTTGCCCGCC
CTTTTGTGAGC -> TTTTGTGAGCG
GAAAAAACGTA -> AAAAAACGTAC
GAAACCACTAG -> AAACCACTAGC
GAAAGATCTCA -> AAAGATCTCAC
GAAATGTACCT -> AAATGTACCTG
GAAATTGGTCT -> AAATTGGTCTA
GAAATTGTTTT -> AAATTGTTTTA
GAAATTTCAAT -> AAATTTCAATC
GAACACTCCTG -> AACACTCCTGT
GAACATACTAG -> AACATACTAGT
GAACCTGGCGG -> AACCTGGCGGT
GAACGAACTCG -> AACGAACTCGC
GAACGTGCCCC -> AACGTGCCCCG
GAACGTTGTGG -> AACGTTGTGGC
GAACTAAGTTT -> AACTAAGTTTA
GAACTAGGTAA -> AACTAGGTAAA
GAACTCGCGAA -> AACTCGCGAAC
GAACTGGAAAT -> AACTGGAAATT
GAACTTCCGTT -> AACTTCCGTTC
GAAGAAATTGG -> AAGAAATTGGT
GAAGACGTACC -> AAGACGTACCC
GAAGAGGCCTG -> AAGAGGCCTGT
GAATAGTATAG -> AATAGTATAGA
GAATGGGTTGT -> AATGGGTTGTG
GAATGTCTCTA -> AATGTCTCTAT
GAATGTTGTAC -> AATGTTGTACC
GAATTAATTGG -> AATTAATTGGT
GACAAAAACGA -> ACAAAAACGAA
GACACACCTCC -> ACACACCTCCA
GACACACTAAA -> ACACACTAAAC
GACACTCCTAA -> ACACTCCTAAC
GACACTTAGTA -> ACACTTAGTAC
GACAGACCCGA -> ACAGACCCGAT
GACAGGATGTC -> ACAGGATGTCT
GACATGAGATC -> ACATGAGATCG
GACATGCCGAC -> ACATGCCGACA
GACATTCGTTG -> ACATTCGTTGT
GACATTTTCAA -> ACATTTTCAAG
GACCAAGGACA -> ACCAAGGACAG
GACCATCTGGA -> ACCATCTGGAT
GACCCAAGGTA -> ACCCAAGGTAT
GACCCAATTCC -> ACCCAATTCCG
GACCCACATTT -> ACCCACATTTC
GACCCCAGTAG -> ACCCCAGTAGA
GACCCGATCGT -> ACCCGATCGTT
GACCCTAGGGG -> ACCCTAGGGGC
GACCGCGTTCA -> ACCGCGTTCAT
GACCTACCTAT -> ACCTACCTATC
GACCTCGGACC -> ACCTCGGACCT
GACCTCGTTTC -> ACCTCGTTTCT
GACCTTAAGCC -> ACCTTAAGCCC
GACGAAAGATC -> ACGAAAGATCT
GACGACGCACC -> ACGACGCACCC
GACGCACCCCC -> ACGCACCCCCT
GACGCAGTAAG -> ACGCAGTAAGA
GACGCCCTTCT -> ACGCCCTTCTC
GACGCCGATGT -> ACGCCGATGTT
GACGCCTAATG -> ACGCCTAATGT
GACGCTAAGGC -> ACGCTAAGGCA
GACGGACGTGA -> ACGGACGTGAA
GACGTACCCTA -> ACGTACCCTAG
GACGTCGCGTA -> ACGTCGCGTAG
GACGTGAATAG -> ACGTGAATAGT
GACTACGTCAG -> ACTACGTCAGA
GACTATTTCCT -> ACTATTTCCTC
GACTCGGGACC -> ACTCGGGACCC
GACTCGGTAGC -> ACTCGGTAGCA
GACTGAACACT -> ACTGAACACTC
GACTGACCTCG -> ACTGACCTCGG
GACTGGCAAAG -> ACTGGCAAAGG
GAGACACACCT -> AGACACACCTC
GAGACGCTAAG -> AGACGCTAAGG
GAGATAATTTG -> AGATAATTTGA
GAGATCGTCGT -> AGATCGTCGTT
GAGCACGGATT -> AGCACGGATTC
GAGCCCCGTGG -> AGCCCCGTGGT
GAGCGTACAAG -> AGCGTACAAGG
GAGGCCTGTGG -> AGGCCTGTGGC
GAGGCTGCACA -> AGGCTGCACAA
GAGGGCTAGGC -> AGGGCTAGGCG
GAGTAATGGCC -> AGTAATGGCCC
GAGTAGGACCG -> AGTAGGACCGC
GAGTCATCGAT -> AGTCATCGATA
GAGTGTTAAGC -> AGTGTTAAGCC
GAGTTCAGCTT -> AGTTCAGCTTT
GAGTTGTCTCA -> AGTTGTCTCAA
GATAATCGGCA -> ATAATCGGCAC
GATAATGGACG -> ATAATGGACGA
GATAATTTGAC -> ATAATTTGACT
GATACACATAA -> ATACACATAAT
GATACATGGCT -> ATACATGGCTG
GATACTGCTAA -> ATACTGCTAAA
GATAGGCGCGC -> ATAGGCGCGCA
GATAGGGCCCC -> ATAGGGCCCCA
GATAGTTGAGC -> ATAGTTGAGCC
GATCCAAAGTA -> ATCCAAAGTAT
GATCCATTGGA -> ATCCATTGGAA
GATCGCTTTGC -> ATCGCTTTGCT
GATCGTCGTTT -> ATCGTCGTTTA
GATCGTTGAAA -> ATCGTTGAAAT
GATCTCACGCT -> ATCTCACGCTC
GATCTCACTTT -> ATCTCACTTTT
GATCTTGGGCT -> ATCTTGGGCTA
GATGCAGTTCA -> ATGCAGTTCAT
GATGCCGCATG -> ATGCCGCATGT
GATGCCGTAGC -> ATGCCGTAGCC
GATGGCAGAGA -> ATGGCAGAGAC
GATGTCTAGAC -> ATGTCTAGACA
GATGTCTGTAT -> ATGTCTGTATG
GATGTGTCTAC -> ATGTGTCTACT
GATGTTATGAC -> ATGTTATGACG
GATGTTCCCAG -> ATGTTCCCAGC
GATGTTTGAGT -> ATGTTTGAGTA
GATTATGCCCA -> ATTATGCCCAT
GATTATTGTAG -> ATTATTGTAGG
GATTCAGCCGC -> ATTCAGCCGCA
GATTCCATTCA -> ATTCCATTCAG
GATTCTCACTA -> ATTCTCACTAG
GCAAAAAGTCA -> CAAAAAGTCAG
GCAAAATCGCG -> CAAAATCGCGC
GCAAAGGACCA -> CAAAGGACCAT
GCAACCATAAA -> CAACCATAAAT
GCAATATTCGG -> CAATATTCGGG
GCAATCTGTAA -> CAATCTGTAAA
GCACAATGCGT -> CACAATGCGTT
GCACACTATTT -> CACACTATTTC
GCACCCCCTAG -> CACCCCCTAGC
GCACGGATTCT -> CACGGATTCTC
GCACGTCTTCA -> CACGTCTTCAT
GCACTTGATAA -> CACTTGATAAT
GCAGAAACCAC -> CAGAAACCACT
GCAGAACGTTG -> CAGAACGTTGT
GCAGAGACGCT -> CAGAGACGCTA
GCAGCGTTATC -> CAGCGTTATCA
GCAGGCCGTAT -> CAGGCCGTATA
GCAGGCGTATA -> CAGGCGTATAT
GCAGGTGCGGC -> CAGGTGCGGCC
GCAGTAAGACT -> CAGTAAGACTG
GCAGTTAGCGA -> CAGTTAGCGAC
GCAGTTCATTC -> CAGTTCATTCT
GCATACATCGC -> CATACATCGCC
GCATACCCCCT -> CATACCCCCTC
GCATACCCGGC -> CATACCCGGCG
GCATACTATAT -> CATACTATATC
GCATCCCCGTG -> CATCCCCGTGA
GCATGAATTAA -> CATGAATTAAT
GCATGCCAGAA -> CATGCCAGAAG
GCATGTTTTGC -> CATGTTTTGCC
GCATTGTCTCA -> CATTGTCTCAC
GCCAATTCATG -> CCAATTCATGC
GCCACCCTAAT -> CCACCCTAATA
GCCACTGCTGA -> CCACTGCTGAG
GCCAGAAGACG -> CCAGAAGACGT
GCCAGCCTTCA -> CCAGCCTTCAC
GCCAGCGCCAT -> CCAGCGCCATA
GCCATAAATCA -> CCATAAATCAA
GCCATCCACAC -> CCATCCACACT
GCCATTTCCTT -> CCATTTCCTTT
GCCCAGCCGAA -> CCCAGCCGAAC
GCCCAGTGACA -> CCCAGTGACAA
GCCCATCAGCG -> CCCATCAGCGT
GCCCCACTTCG -> CCCCACTTCGC
GCCCCGAATGT -> CCCCGAATGTT
GCCCCGGCTCA -> CCCCGGCTCAG
GCCCCGTGGTT -> CCCCGTGGTTT
GCCCGCAGTTA -> CCCGCAGTTAG
GCCCGCCGTAA -> CCCGCCGTAAC
GCCCGGTCCTG -> CCCGGTCCTGA
GCCCTCTCTGG -> CCCTCTCTGGT
GCCCTTCTCGG -> CCCTTCTCGGA
GCCGAACCTGG -> CCGAACCTGGC
GCCGACACACT -> CCGACACACTA
GCCGACACTTA -> CCGACACTTAG
GCCGACGCCGA -> CCGACGCCGAT
GCCGATGTTTG -> CCGATGTTTGA
GCCGCATGAAT -> CCGCATGAATT
GCCGCATGCCA -> CCGCATGCCAG
GCCGCATGTTT -> CCGCATGTTTT
GCCGGGTGACT -> CCGGGTGACTG
GCCGTAACCTC -> CCGTAACCTCT
GCCGTAGCCAC -> CCGTAGCCACT
GCCGTATATCT -> CCGTATATCTA
GCCGTTGAGTT -> CCGTTGAGTTC
GCCTAATGTCG -> CCTAATGTCGA
GCCTGTGGCGC -> CCTGTGGCGCC
GCCTTCACGAC -> CCTTCACGACC
GCGAACTAGGT -> CGAACTAGGTA
GCGACACTCCT -> CGACACTCCTA
GCGACCTACCT -> CGACCTACCTA
GCGACGCAGTA -> CGACGCAGTAA
GCGACGGACGT -> CGACGGACGTG
GCGATGTTCCC -> CGATGTTCCCA
GCGATTCCATT -> CGATTCCATTC
GCGCAATCTGT -> CGCAATCTGTA
GCGCCAGCCTT -> CGCCAGCCTTC
GCGCCATAAAT -> CGCCATAAATC
GCGCCATTTCC -> CGCCATTTCCT
GCGCGCAATCT -> CGCGCAATCTG
GCGCGTGGTTA -> CGCGTGGTTAG
GCGGACGCCCT -> CGGACGCCCTT
GCGGCCACCCT -> CGGCCACCCTA
GCGGGGCAAAA -> CGGGGCAAAAA
GCGGTTGAGAT -> CGGTTGAGATA
GCGTACAAGGA -> CGTACAAGGAA
GCGTAGGCAAA -> CGTAGGCAAAA
GCGTATATTGA -> CGTATATTGAT
GCGTATGTCCG -> CGTATGTCCGA
GCGTGAGCACG -> CGTGAGCACGG
GCGTGGCCGAC -> CGTGGCCGACA
GCGTGGTTAGC -> CGTGGTTAGCA
GCGTTATCAGA -> CGTTATCAGAT
GCGTTCATCAC -> CGTTCATCACG
GCGTTCCGACA -> CGTTCCGACAT
GCGTTGTAAAA -> CGTTGTAAAAC
GCTAAAGCCGT -> CTAAAGCCGTT
GCTAAATTATC -> CTAAATTATCT
GCTAAGACTGA -> CTAAGACTGAA
GCTAAGGCACT -> CTAAGGCACTT
GCTACAACACA -> CTACAACACAA
GCTACCTCAAA -> CTACCTCAAAC
GCTACTAAGAT -> CTACTAAGATG
GCTAGAGTGTT -> CTAGAGTGTTA
GCTAGGCGTGA -> CTAGGCGTGAG
GCTAGTGACAT -> CTAGTGACATG
GCTATTCACTC -> CTATTCACTCT
GCTCAATACCA -> CTCAATACCAG
GCTCAGGAACA -> CTCAGGAACAT
GCTCGGGCTAA -> CTCGGGCTAAA
GCTCGTATTAT -> CTCGTATTATG
GCTCTCTTTTC -> CTCTCTTTTCG
GCTCTGATTCA -> CTCTGATTCAG
GCTGAGTCATC -> CTGAGTCATCG
GCTGATACACA -> CTGATACACAT
GCTGCACAATG -> CTGCACAATGC
GCTGCATACCC -> CTGCATACCCC
GCTGGAATGGG -> CTGGAATGGGT
GCTGTCGGATG -> CTGTCGGATGT
GCTTACCGCCC -> CTTACCGCCCG
GCTTTGCTACA -> CTTTGCTACAA
GCTTTGTCTCC -> CTTTGTCTCCC
GCTTTTGCCCG -> CTTTTGCCCGC
GGAAATTGTTT -> GAAATTGTTTT
GGAACATACTA -> GAACATACTAG
GGAACTAAGTT -> GAACTAAGTTT
GGAACTGGAAA -> GAACTGGAAAT
GGAAGAAATTG -> GAAGAAATTGG
GGAATGGGTTG -> GAATGGGTTGT
GGAATGTCTCT -> GAATGTCTCTA
GGACAGGATGT -> GACAGGATGTC
GGACCATCTGG -> GACCATCTGGA
GGACCCAAGGT -> GACCCAAGGTA
GGACCCTAGGG -> GACCCTAGGGG
GGACCGCGTTC -> GACCGCGTTCA
GGACCTCGTTT -> GACCTCGTTTC
GGACCTTAAGC -> GACCTTAAGCC
GGACGAAAGAT -> GACGAAAGATC
GGACGCCCTTC -> GACGCCCTTCT
GGACGTCGCGT -> GACGTCGCGTA
GGACGTGAATA -> GACGTGAATAG
GGACTACGTCA -> GACTACGTCAG
GGAGACACACC -> GAGACACACCT
GGATACTGCTA -> GATACTGCTAA
GGATAGGGCCC -> GATAGGGCCCC
GGATAGTTGAG -> GATAGTTGAGC
GGATCCATTGG -> GATCCATTGGA
GGATCTCACTT -> GATCTCACTTT
GGATGTCTAGA -> GATGTCTAGAC
GGATGTCTGTA -> GATGTCTGTAT
GGATTCTCACT -> GATTCTCACTA
GGCAAAAAGTC -> GCAAAAAGTCA
GGCAAAATCGC -> GCAAAATCGCG
GGCAAAGGACC -> GCAAAGGACCA
GGCACACTATT -> GCACACTATTT
GGCACGTCTTC -> GCACGTCTTCA
GGCACTTGATA -> GCACTTGATAA
GGCAGAAACCA -> GCAGAAACCAC
GGCAGAGACGC -> GCAGAGACGCT
GGCAGCGTTAT -> GCAGCGTTATC
GGCAGGCCGTA -> GCAGGCCGTAT
GGCCACCCTAA -> GCCACCCTAAT
GGCCCCACTTC -> GCCCCACTTCG
GGCCCCGGCTC -> GCCCCGGCTCA
GGCCGACACAC -> GCCGACACACT
GGCCGGGTGAC -> GCCGGGTGACT
GGCCGTATATC -> GCCGTATATCT
GGCCTGTGGCG -> GCCTGTGGCGC
GGCGACGCAGT -> GCGACGCAGTA
GGCGATGTTCC -> GCGATGTTCCC
GGCGCCAGCCT -> GCGCCAGCCTT
GGCGCCATTTC -> GCGCCATTTCC
GGCGCGCAATC -> GCGCGCAATCT
GGCGGGGCAAA -> GCGGGGCAAAA
GGCGGTTGAGA -> GCGGTTGAGAT
GGCGTATATTG -> GCGTATATTGA
GGCGTGAGCAC -> GCGTGAGCACG
GGCTAAATTAT -> GCTAAATTATC
GGCTAAGACTG -> GCTAAGACTGA
GGCTACCTCAA -> GCTACCTCAAA
GGCTAGGCGTG -> GCTAGGCGTGA
GGCTCAGGAAC -> GCTCAGGAACA
GGCTGATACAC -> GCTGATACACA
GGCTGCACAAT -> GCTGCACAATG
GGCTGGAATGG -> GCTGGAATGGG
GGCTGTCGGAT -> GCTGTCGGATG
GGCTTTTGCCC -> GCTTTTGCCCG
GGGAAGAAATT -> GGAAGAAATTG
GGGACCCTAGG -> GGACCCTAGGG
GGGAGACACAC -> GGAGACACACC
GGGATAGGGCC -> GGATAGGGCCC
GGGATCTCACT -> GGATCTCACTT
GGGCAAAAAGT -> GGCAAAAAGTC
GGGCCCCACTT -> GGCCCCACTTC
GGGCTAAATTA -> GGCTAAATTAT
GGGCTACCTCA -> GGCTACCTCAA
GGGCTAGGCGT -> GGCTAGGCGTG
GGGCTGGAATG -> GGCTGGAATGG
GGGCTGTCGGA -> GGCTGTCGGAT
GGGGAAGAAAT -> GGGAAGAAATT
GGGGCAAAAAG -> GGGCAAAAAGT
GGGGCTGTCGG -> GGGCTGTCGGA
GGGTGACTGGC -> GGTGACTGGCA
GGGTTGTGCAG -> GGTTGTGCAGG
GGTAAATTATT -> GTAAATTATTC
GGTAACCTTCA -> GTAACCTTCAA
GGTAGACGACG -> GTAGACGACGC
GGTAGCAGGTG -> GTAGCAGGTGC
GGTATGCTATT -> GTATGCTATTC
GGTCAGCTCAA -> GTCAGCTCAAT
GGTCAGTGCGA -> GTCAGTGCGAC
GGTCCGCTTAC -> GTCCGCTTACC
GGTCCTGAAAA -> GTCCTGAAAAA
GGTCTAGAGTA -> GTCTAGAGTAA
GGTGACTGGCA -> GTGACTGGCAA
GGTGATGGCAG -> GTGATGGCAGA
GGTGCGGCCAC -> GTGCGGCCACC
GGTTAGCATTG -> GTTAGCATTGT
GGTTGAGATAA -> GTTGAGATAAT
GGTTGTGCAGG -> GTTGTGCAGGC
GGTTTCACTTG -> GTTTCACTTGA
GTAAAACGGCA -> TAAAACGGCAG
GTAAATCGTGG -> TAAATCGTGGT
GTAAATTATTC -> TAAATTATTCG
GTAACCTCTAC -> TAACCTCTACT
GTAACCTTCAA -> TAACCTTCAAA
GTAACGATACA -> TAACGATACAT
GTAAGACTGAC -> TAAGACTGACC
GTAATCCCGTC -> TAATCCCGTCT
GTAATGGCCCC -> TAATGGCCCCG
GTAATTTAAGC -> TAATTTAAGCG
GTACAAGGAAC -> TACAAGGAACT
GTACAGAACGT -> TACAGAACGTG
GTACCCTAGTA -> TACCCTAGTAG
GTACCTAATGG -> TACCTAATGGA
GTACCTGTCTC -> TACCTGTCTCG
GTACCTTTACG -> TACCTTTACGT
GTACGAGGGCT -> TACGAGGGCTA
GTAGACCCAAT -> TAGACCCAATT
GTAGACGACGC -> TAGACGACGCA
GTAGCAACCAT -> TAGCAACCATA
GTAGCAGGTGC -> TAGCAGGTGCG
GTAGCCACTGC -> TAGCCACTGCT
GTAGGACCGCG -> TAGGACCGCGT
GTAGGACGTCG -> TAGGACGTCGC
GTAGGCAAAAT -> TAGGCAAAATC
GTAGGCCGGGT -> TAGGCCGGGTG
GTAGTGCCCGC -> TAGTGCCCGCA
GTAGTGCGATT -> TAGTGCGATTC
GTATACTCGCC -> TATACTCGCCA
GTATAGACCAA -> TATAGACCAAG
GTATATCTACC -> TATATCTACCT
GTATATTGATC -> TATATTGATCC
GTATGATAGGC -> TATGATAGGCG
GTATGCTATTC -> TATGCTATTCA
GTATGCTGCAT -> TATGCTGCATA
GTATGTCCGAG -> TATGTCCGAGC
GTATTATGGGA -> TATTATGGGAT
GTCAAGGTGAT -> TCAAGGTGATG
GTCAGATCGCT -> TCAGATCGCTT
GTCAGATGCCG -> TCAGATGCCGT
GTCAGCTCAAT -> TCAGCTCAATA
GTCAGTGCGAC -> TCAGTGCGACG
GTCATCGATAA -> TCATCGATAAT
GTCCGCTTACC -> TCCGCTTACCG
GTCCTGAAAAA -> TCCTGAAAAAA
GTCGAACTTCC -> TCGAACTTCCG
GTCGCGTAGGC -> TCGCGTAGGCA
GTCGGATGTCT -> TCGGATGTCTG
GTCGTAGTGCC -> TCGTAGTGCCC
GTCGTTTAGCC -> TCGTTTAGCCC
GTCTAAAAGAT -> TCTAAAAGATT
GTCTACTTATT -> TCTACTTATTT
GTCTAGACAGA -> TCTAGACAGAC
GTCTAGAGTAA -> TCTAGAGTAAT
GTCTCAAGTAC -> TCTCAAGTACG
GTCTCACTTGT -> TCTCACTTGTT
GTCTCCCTGCA -> TCTCCCTGCAT
GTCTCGGGAGA -> TCTCGGGAGAC
GTCTCTATGGA -> TCTCTATGGAC
GTCTGGCGATG -> TCTGGCGATGT
GTCTGTATGAT -> TCTGTATGATA
GTCTTCATTCC -> TCTTCATTCCG
GTGAATAGTAT -> TGAATAGTATA
GTGACAAAAAC -> TGACAAAAACG
GTGACATGCCG -> TGACATGCCGA
GTGACTGGCAA -> TGACTGGCAAA
GTGAGCACGGA -> TGAGCACGGAT
GTGAGCGTACA -> TGAGCGTACAA
GTGAGTTGTCT -> TGAGTTGTCTC
GTGATGGCAGA -> TGATGGCAGAG
GTGCAGGCGTA -> TGCAGGCGTAT
GTGCCCCGAAT -> TGCCCCGAATG
GTGCCCGCAGT -> TGCCCGCAGTT
GTGCGACGGAC -> TGCGACGGACG
GTGCGATTCCA -> TGCGATTCCAT
GTGCGGACGCC -> TGCGGACGCCC
GTGCGGCCACC -> TGCGGCCACCC
GTGGCCGACAC -> TGGCCGACACA
GTGGCGACGCA -> TGGCGACGCAG
GTGGCGCCAGC -> TGGCGCCAGCC
GTGGTCAGCTC -> TGGTCAGCTCA
GTGGTTAGCAT -> TGGTTAGCATT
GTGGTTTCACT -> TGGTTTCACTT
GTGTCTACTTA -> TGTCTACTTAT
GTGTTAAGCCA -> TGTTAAGCCAG
GTTAAGCCAGC -> TTAAGCCAGCG
GTTAATGACAT -> TTAATGACATG
GTTAATTTGAT -> TTAATTTGATG
GTTAGCATTGT -> TTAGCATTGTC
GTTAGCGACAC -> TTAGCGACACT
GTTATCAGATG -> TTATCAGATGT
GTTATGACGCC -> TTATGACGCCT
GTTCAGCTTTG -> TTCAGCTTTGT
GTTCATCACGC -> TTCATCACGCT
GTTCATCTACA -> TTCATCTACAA
GTTCATTCTGG -> TTCATTCTGGT
GTTCCCAGCAA -> TTCCCAGCAAT
GTTCCGACATT -> TTCCGACATTC
GTTCGGGATAG -> TTCGGGATAGG
GTTGAAATTTC -> TTGAAATTTCA
GTTGAGATAAT -> TTGAGATAATT
GTTGAGCCCCG -> TTGAGCCCCGT
GTTGAGTTCAG -> TTGAGTTCAGC
GTTGGCACGTC -> TTGGCACGTCT
GTTGTAAAACG -> TTGTAAAACGG
GTTGTAATCCC -> TTGTAATCCCG
GTTGTACCTTT -> TTGTACCTTTA
GTTGTCTCAAG -> TTGTCTCAAGT
GTTGTGCAGGC -> TTGTGCAGGCG
GTTGTGGCGAC -> TTGTGGCGACG
GTTTAGCCCAG -> TTTAGCCCAGT,TTTAGCCCAGC
GTTTCACTTGA -> TTTCACTTGAA
GTTTCTTTTAG -> TTTCTTTTAGA
GTTTGAGTAGG -> TTTGAGTAGGA
GTTTTATAAGT -> TTTTATAAGTA
GTTTTGCCAAT -> TTTTGCCAATT
TAAAACGGCAG -> AAAACGGCAGC
TAAAAGATTAT -> AAAAGATTATG
TAAACGATTAT -> AAACGATTATT
TAAAGCCGTTG -> AAAGCCGTTGA
TAAATCAAGTC -> AAATCAAGTCT
TAAATCGTGGT -> AAATCGTGGTC
TAAATTATCTT -> AAATTATCTTT
TAAATTATTCG -> AAATTATTCGT
TAAATTTGACC -> AAATTTGACCC
TAACCAATTCC -> AACCAATTCCG
TAACCGGCTAA -> AACCGGCTAAG
TAACCTCTACT -> AACCTCTACTG
TAACCTTCAAA -> AACCTTCAAAT
TAACGAGGCTG -> AACGAGGCTGC
TAACGATACAT -> AACGATACATG
TAACGCGACCT -> AACGCGACCTA
TAAGACTGAAC -> AAGACTGAACA
TAAGACTGACC -> AAGACTGACCT
TAAGATGTGTC -> AAGATGTGTCT
TAAGCCAGCGC -> AAGCCAGCGCC
TAAGCCCTCTC -> AAGCCCTCTCT
TAAGCGTTCCG -> AAGCGTTCCGA
TAAGGCACTTG -> AAGGCACTTGA
TAAGTATACTC -> AAGTATACTCG
TAAGTTTAGCC -> AAGTTTAGCCC
TAATAGCCGCA -> AATAGCCGCAT
TAATCCCGTCT -> AATCCCGTCTA
TAATCGGCACA -> AATCGGCACAC
TAATGACATGA -> AATGACATGAG
TAATGCATACA -> AATGCATACAT
TAATGGACGAA -> AATGGACGAAA
TAATGGATAGT -> AATGGATAGTT
TAATGGCCCCG -> AATGGCCCCGG
TAATGTCGAAC -> AATGTCGAACT
TAATTGGTAGA -> AATTGGTAGAC
TAATTTAAGCG -> AATTTAAGCGT
TAATTTGACTC -> AATTTGACTCG
TAATTTGATGC -> AATTTGATGCA
TACAACACAAT -> ACAACACAATT
TACAAGGAACT -> ACAAGGAACTA
TACAAGTTAAT -> ACAAGTTAATT
TACACATAATG -> ACACATAATGC
TACAGAACGTG -> ACAGAACGTGC
TACATCGCCGA -> ACATCGCCGAC
TACATGGCTGA -> ACATGGCTGAT
TACCAGGCTTT -> ACCAGGCTTTT
TACCCCCTCGA -> ACCCCCTCGAA
TACCCGGCGCC -> ACCCGGCGCCA
TACCCTAGTAG -> ACCCTAGTAGT
TACCGCCCGGT -> ACCGCCCGGTC
TACCTAACGAG -> ACCTAACGAGG
TACCTAATGGA -> ACCTAATGGAT
TACCTATCGTA -> ACCTATCGTAA
TACCTCAAACT -> ACCTCAAACTT
TACCTGTCTCG -> ACCTGTCTCGG
TACCTTTACGT -> ACCTTTACGTC
TACGAGGGCTA -> ACGAGGGCTAG
TACGTCAGATG -> ACGTCAGATGC
TACGTCGTAGT -> ACGTCGTAGTG
TACTAAGATGT -> ACTAAGATGTG
TACTAGTCAAG -> ACTAGTCAAGG
TACTATATCCT -> ACTATATCCTA
TACTCGCCATC -> ACTCGCCATCC
TACTGCTAAAG -> ACTGCTAAAGC
TACTGTAGGAC -> ACTGTAGGACG
TACTTATTTTG -> ACTTATTTTGA
TAGACAGACCC -> AGACAGACCCG
TAGACCAAGGA -> AGACCAAGGAC
TAGACCCAATT -> AGACCCAATTC
TAGACGACGCA -> AGACGACGCAC
TAGACTATTTC -> AGACTATTTCC
TAGACTCGGGA -> AGACTCGGGAC
TAGAGTAATGG -> AGAGTAATGGC
TAGAGTGTTAA -> AGAGTGTTAAG
TAGCAACCATA -> AGCAACCATAA
TAGCAGGTGCG -> AGCAGGTGCGG
TAGCATACCCG -> AGCATACCCGG
TAGCATTGTCT -> AGCATTGTCTC
TAGCCACTGCT -> AGCCACTGCTG
TAGCCCAGCCG -> AGCCCAGCCGA
TAGCCCAGTGA -> AGCCCAGTGAC
TAGCCGCATGA -> AGCCGCATGAA
TAGCGACACTC -> AGCGACACTCC
TAGCTCGTATT -> AGCTCGTATTA
TAGGACCGCGT -> AGGACCGCGTT
TAGGACGTCGC -> AGGACGTCGCG
TAGGCAAAATC -> AGGCAAAATCG
TAGGCCGGGTG -> AGGCCGGGTGA
TAGGCGCGCAA -> AGGCGCGCAAT
TAGGCGTGAGC -> AGGCGTGAGCA
TAGGGCCCCAC -> AGGGCCCCACT
TAGGGGCTGTC -> AGGGGCTGTCG
TAGGTAAATTA -> AGGTAAATTAT
TAGTACAGAAC -> AGTACAGAACG
TAGTAGTGCGA -> AGTAGTGCGAT
TAGTATAGACC -> AGTATAGACCA
TAGTCAAGGTG -> AGTCAAGGTGA
TAGTGACATGC -> AGTGACATGCC
TAGTGCCCGCA -> AGTGCCCGCAG
TAGTGCGATTC -> AGTGCGATTCC
TAGTTGAGCCC -> AGTTGAGCCCC
TATAAGTATAC -> ATAAGTATACT
TATACTCGCCA -> ATACTCGCCAT
TATAGACCAAG -> ATAGACCAAGG
TATATCCTAAC -> ATATCCTAACG
TATATCTACCT -> ATATCTACCTA
TATATTGATCC -> ATATTGATCCA
TATCAGATGTT -> ATCAGATGTTA
TATCCTAACGC -> ATCCTAACGCG
TATCGGACTAC -> ATCGGACTACG
TATCGTAATTT -> ATCGTAATTTA
TATCTACCTAA -> ATCTACCTAAC
TATCTTTTCTG -> ATCTTTTCTGG
TATGACGCCTA -> ATGACGCCTAA
TATGATAGGCG -> ATGATAGGCGC
TATGCCCATCA -> ATGCCCATCAG
TATGCTATTCA -> ATGCTATTCAC
TATGCTGCATA -> ATGCTGCATAC
TATGGACCCAA -> ATGGACCCAAG
TATGGGATCTC -> ATGGGATCTCA
TATGTCCGAGC -> ATGTCCGAGCG
TATTATGGGAT -> ATTATGGGATC
TATTCACTCTA -> ATTCACTCTAA
TATTCGGGCTG -> ATTCGGGCTGG
TATTCGTGCGG -> ATTCGTGCGGA
TATTGATCCAA -> ATTGATCCAAA
TATTGTAGGCC -> ATTGTAGGCCG
TATTTCCTCAG -> ATTTCCTCAGC
TATTTCGGTCC -> ATTTCGGTCCG
TATTTTGACAT -> ATTTTGACATT
TCAAACTTTCT -> CAAACTTTCTA
TCAAATCTGCA -> CAAATCTGCAT
TCAAGCTCTCT -> CAAGCTCTCTT
TCAAGGTGATG -> CAAGGTGATGG
TCAAGTACGAG -> CAAGTACGAGG
TCAAGTCTGGC -> CAAGTCTGGCG
TCAATACCAGG -> CAATACCAGGC
TCAATCATTGC -> CAATCATTGCG
TCACGACCCCA -> CACGACCCCAG
TCACGCTACTA -> CACGCTACTAA
TCACGCTCTGA -> CACGCTCTGAT
TCACTAGACTC -> CACTAGACTCG
TCACTCTAACC -> CACTCTAACCA
TCACTTGAAAT -> CACTTGAAATG
TCACTTGTTGG -> CACTTGTTGGC
TCACTTTTGTG -> CACTTTTGTGA
TCAGATCGCTT -> CAGATCGCTTT
TCAGATGCCGT -> CAGATGCCGTA
TCAGATGTTAT -> CAGATGTTATG
TCAGCCGCATG -> CAGCCGCATGC
TCAGCGTATGT -> CAGCGTATGTC
TCAGCTCAATA -> CAGCTCAATAC
TCAGCTCGGGC -> CAGCTCGGGCT
TCAGCTTTGTC -> CAGCTTTGTCT
TCAGGAACATA -> CAGGAACATAC
TCAGTAACGAT -> CAGTAACGATA
TCAGTGCGACG -> CAGTGCGACGG
TCATCACGCTA -> CATCACGCTAC
TCATCGATAAT -> CATCGATAATG
TCATCTACAAG -> CATCTACAAGT
TCATGATGCCG -> CATGATGCCGC
TCATGCAGAAC -> CATGCAGAACG
TCATTCCGGCA -> CATTCCGGCAG
TCATTCTGGTC -> CATTCTGGTCA
TCATTGCGTGG -> CATTGCGTGGC
TCCAAAGTATG -> CCAAAGTATGC
TCCACACTGGC -> CCACACTGGCA
TCCACCGATCT -> CCACCGATCTT
TCCATTCAGTA -> CCATTCAGTAA
TCCATTGGAAT -> CCATTGGAATG
TCCCAGCAATA -> CCCAGCAATAT
TCCCCGTGAGT -> CCCCGTGAGTT
TCCCGTCTAAA -> CCCGTCTAAAA
TCCCTGCATCC -> CCCTGCATCCC
TCCGACATTCG -> CCGACATTCGT
TCCGCTAGAGT -> CCGCTAGAGTG
TCCGCTTACCG -> CCGCTTACCGC
TCCGGCAGAAA -> CCGGCAGAAAC
TCCGGCGGGGC -> CCGGCGGGGCA
TCCGTTCGGGA -> CCGTTCGGGAT
TCCTAACCGGC -> CCTAACCGGCT
TCCTAACGCGA -> CCTAACGCGAC
TCCTCAGCTCG -> CCTCAGCTCGG
TCCTGAAAAAA -> CCTGAAAAAAC
TCCTGTAGCAA -> CCTGTAGCAAC
TCCTTTGGGGA -> CCTTTGGGGAA
TCGAACGAACT -> CGAACGAACTC
TCGAACTTCCG -> CGAACTTCCGT
TCGATAATGGA -> CGATAATGGAC
TCGCCATCCAC -> CGCCATCCACA
TCGCCGACGCC -> CGCCGACGCCG
TCGCGAACTAG -> CGCGAACTAGG
TCGCGCGTGGT -> CGCGCGTGGTT
TCGCGTAGGCA -> CGCGTAGGCAA
TCGCTAGTGAC -> CGCTAGTGACA
TCGCTTTGCTA -> CGCTTTGCTAC
TCGGAACTGGA -> CGGAACTGGAA
TCGGACCTCGT -> CGGACCTCGTT
TCGGACTACGT -> CGGACTACGTC
TCGGATGTCTG -> CGGATGTCTGT
TCGGCACACTA -> CGGCACACTAT
TCGGGACCCTA -> CGGGACCCTAG
TCGGGAGACAC -> CGGGAGACACA
TCGGGATAGGG -> CGGGATAGGGC
TCGGGCTAAAT -> CGGGCTAAATT
TCGGGCTGGAA -> CGGGCTGGAAT
TCGGTAGCAGG -> CGGTAGCAGGT
TCGGTCCGCTT -> CGGTCCGCTTA
TCGTAATTTAA -> CGTAATTTAAG
TCGTAGTGCCC -> CGTAGTGCCCG
TCGTATTATGG -> CGTATTATGGG
TCGTCGTTTAG -> CGTCGTTTAGC
TCGTGCGGACG -> CGTGCGGACGC
TCGTGGTCAGC -> CGTGGTCAGCT
TCGTTCATCTA -> CGTTCATCTAC
TCGTTGAAATT -> CGTTGAAATTT
TCGTTGTAATC -> CGTTGTAATCC
TCGTTTAGCCC -> CGTTTAGCCCA
TCGTTTCTTTT -> CGTTTCTTTTA
TCTAAAAGATT -> CTAAAAGATTA
TCTAACCAATT -> CTAACCAATTC
TCTACAAGTTA -> CTACAAGTTAA
TCTACCTAACG -> CTACCTAACGA
TCTACTGTAGG -> CTACTGTAGGA
TCTACTTATTT -> CTACTTATTTT
TCTAGACAGAC -> CTAGACAGACC
TCTAGAGTAAT -> CTAGAGTAATG
TCTATCGGACT -> CTATCGGACTA
TCTATGGACCC -> CTATGGACCCA
TCTCAAGTACG -> CTCAAGTACGA
TCTCACGCTCT -> CTCACGCTCTG
TCTCACTAGAC -> CTCACTAGACT
TCTCACTTGTT -> CTCACTTGTTG
TCTCACTTTTG -> CTCACTTTTGT
TCTCCCTGCAT -> CTCCCTGCATC
TCTCGGAACTG -> CTCGGAACTGG
TCTCGGGAGAC -> CTCGGGAGACA
TCTCTATGGAC -> CTCTATGGACC
TCTCTGGTAAC -> CTCTGGTAACC
TCTCTTTTCGT -> CTCTTTTCGTT
TCTGATTCAGC -> CTGATTCAGCC
TCTGCATACTA -> CTGCATACTAT
TCTGGATACTG -> CTGGATACTGC
TCTGGATCCAT -> CTGGATCCATT
TCTGGCGATGT -> CTGGCGATGTT
TCTGGTAACCT -> CTGGTAACCTT
TCTGGTCAGTG -> CTGGTCAGTGC
TCTGTAAATCG -> CTGTAAATCGT
TCTGTATGATA -> CTGTATGATAG
TCTTCATTCCG -> CTTCATTCCGG
TCTTGGGCTAC -> CTTGGGCTACC
TCTTTTAGACT -> CTTTTAGACTA
TCTTTTCGTTC -> CTTTTCGTTCA
TCTTTTCTGGA -> CTTTTCTGGAT
TGAAAAAACGT -> GAAAAAACGTA
TGAAATGTACC -> GAAATGTACCT
TGAAATTTCAA -> GAAATTTCAAT
TGAACACTCCT -> GAACACTCCTG
TGAATAGTATA -> GAATAGTATAG
TGAATTAATTG -> GAATTAATTGG
TGACAAAAACG -> GACAAAAACGA
TGACATGAGAT -> GACATGAGATC
TGACATGCCGA -> GACATGCCGAC
TGACATTTTCA -> GACATTTTCAA
TGACCCACATT -> GACCCACATTT
TGACCTCGGAC -> GACCTCGGACC
TGACGCCTAAT -> GACGCCTAATG
TGACTCGGTAG -> GACTCGGTAGC
TGACTGGCAAA -> GACTGGCAAAG
TGAGATAATTT -> GAGATAATTTG
TGAGATCGTCG -> GAGATCGTCGT
TGAGCACGGAT -> GAGCACGGATT
TGAGCCCCGTG -> GAGCCCCGTGG
TGAGCGTACAA -> GAGCGTACAAG
TGAGTAGGACC -> GAGTAGGACCG
TGAGTCATCGA -> GAGTCATCGAT
TGAGTTCAGCT -> GAGTTCAGCTT
TGAGTTGTCTC -> GAGTTGTCTCA
TGATAATCGGC -> GATAATCGGCA
TGATACACATA -> GATACACATAA
TGATAGGCGCG -> GATAGGCGCGC
TGATCCAAAGT -> GATCCAAAGTA
TGATGCAGTTC -> GATGCAGTTCA
TGATGCCGCAT -> GATGCCGCATG
TGATGGCAGAG -> GATGGCAGAGA
TGATTCAGCCG -> GATTCAGCCGC
TGCACAATGCG -> GCACAATGCGT
TGCAGAACGTT -> GCAGAACGTTG
TGCAGGCGTAT -> GCAGGCGTATA
TGCAGTTCATT -> GCAGTTCATTC
TGCATACATCG -> GCATACATCGC
TGCATACCCCC -> GCATACCCCCT
TGCATACTATA -> GCATACTATAT
TGCATCCCCGT -> GCATCCCCGTG
TGCCAATTCAT -> GCCAATTCATG
TGCCAGAAGAC -> GCCAGAAGACG
TGCCCATCAGC -> GCCCATCAGCG
TGCCCCGAATG -> GCCCCGAATGT
TGCCCGCAGTT -> GCCCGCAGTTA
TGCCCGCCGTA -> GCCCGCCGTAA
TGCCGACACTT -> GCCGACACTTA
TGCCGCATGTT -> GCCGCATGTTT
TGCCGTAGCCA -> GCCGTAGCCAC
TGCGACGGACG -> GCGACGGACGT
TGCGATTCCAT -> GCGATTCCATT
TGCGGACGCCC -> GCGGACGCCCT
TGCGGCCACCC -> GCGGCCACCCT
TGCGTGGCCGA -> GCGTGGCCGAC
TGCGTTGTAAA -> GCGTTGTAAAA
TGCTAAAGCCG -> GCTAAAGCCGT
TGCTACAACAC -> GCTACAACACA
TGCTATTCACT -> GCTATTCACTC
TGCTGAGTCAT -> GCTGAGTCATC
TGCTGCATACC -> GCTGCATACCC
TGGAAATTGTT -> GGAAATTGTTT
TGGAATGGGTT -> GGAATGGGTTG
TGGAATGTCTC -> GGAATGTCTCT
TGGACCCAAGG -> GGACCCAAGGT
TGGACCTTAAG -> GGACCTTAAGC
TGGACGAAAGA -> GGACGAAAGAT
TGGATACTGCT -> GGATACTGCTA
TGGATAGTTGA -> GGATAGTTGAG
TGGATCCATTG -> GGATCCATTGG
TGGCAAAGGAC -> GGCAAAGGACC
TGGCACGTCTT -> GGCACGTCTTC
TGGCAGAGACG -> GGCAGAGACGC
TGGCAGGCCGT -> GGCAGGCCGTA
TGGCCCCGGCT -> GGCCCCGGCTC
TGGCCGACACA -> GGCCGACACAC
TGGCGACGCAG -> GGCGACGCAGT
TGGCGATGTTC -> GGCGATGTTCC
TGGCGCCAGCC -> GGCGCCAGCCT
TGGCGGTTGAG -> GGCGGTTGAGA
TGGCTGATACA -> GGCTGATACAC
TGGGATCTCAC -> GGGATCTCACT
TGGGCTACCTC -> GGGCTACCTCA
TGGGGAAGAAA -> GGGGAAGAAAT
TGGGTTGTGCA -> GGGTTGTGCAG
TGGTAACCTTC -> GGTAACCTTCA
TGGTAGACGAC -> GGTAGACGACG
TGGTCAGCTCA -> GGTCAGCTCAA
TGGTCAGTGCG -> GGTCAGTGCGA
TGGTCTAGAGT -> GGTCTAGAGTA
TGGTTAGCATT -> GGTTAGCATTG
TGGTTTCACTT -> GGTTTCACTTG
TGTAAAACGGC -> GTAAAACGGCA
TGTAAATCGTG -> GTAAATCGTGG
TGTAATCCCGT -> GTAATCCCGTC
TGTACCTGTCT -> GTACCTGTCTC
TGTACCTTTAC -> GTACCTTTACG
TGTAGCAACCA -> GTAGCAACCAT
TGTAGGACGTC -> GTAGGACGTCG
TGTAGGCCGGG -> GTAGGCCGGGT
TGTATGATAGG -> GTATGATAGGC
TGTCGAACTTC -> GTCGAACTTCC
TGTCGGATGTC -> GTCGGATGTCT
TGTCTACTTAT -> GTCTACTTATT
TGTCTAGACAG -> GTCTAGACAGA
TGTCTCAAGTA -> GTCTCAAGTAC
TGTCTCACTTG -> GTCTCACTTGT
TGTCTCCCTGC -> GTCTCCCTGCA
TGTCTCGGGAG -> GTCTCGGGAGA
TGTCTCTATGG -> GTCTCTATGGA
TGTCTGTATGA -> GTCTGTATGAT
TGTGAGCGTAC -> GTGAGCGTACA
TGTGCAGGCGT -> GTGCAGGCGTA
TGTGGCGACGC -> GTGGCGACGCA
TGTGGCGCCAG -> GTGGCGCCAGC
TGTGTCTACTT -> GTGTCTACTTA
TGTTAAGCCAG -> GTTAAGCCAGC
TGTTATGACGC -> GTTATGACGCC
TGTTCCCAGCA -> GTTCCCAGCAA
TGTTGGCACGT -> GTTGGCACGTC
TGTTGTACCTT -> GTTGTACCTTT
TGTTTGAGTAG -> GTTTGAGTAGG
TGTTTTATAAG -> GTTTTATAAGT
TGTTTTGCCAA -> GTTTTGCCAAT
TTAAGCCAGCG -> TAAGCCAGCGC
TTAAGCCCTCT -> TAAGCCCTCTC
TTAAGCGTTCC -> TAAGCGTTCCG
TTAATGACATG -> TAATGACATGA
TTAATTGGTAG -> TAATTGGTAGA
TTAATTTGATG -> TAATTTGATGC
TTACCGCCCGG -> TACCGCCCGGT
TTACGTCGTAG -> TACGTCGTAGT
TTAGACTATTT -> TAGACTATTTC
TTAGCATTGTC -> TAGCATTGTCT
TTAGCCCAGCC -> TAGCCCAGCCG
TTAGCCCAGTG -> TAGCCCAGTGA
TTAGCGACACT -> TAGCGACACTC
TTAGTACAGAA -> TAGTACAGAAC
TTATAAGTATA -> TATAAGTATAC
TTATCAGATGT -> TATCAGATGTT
TTATCTTTTCT -> TATCTTTTCTG
TTATGACGCCT -> TATGACGCCTA
TTATGCCCATC -> TATGCCCATCA
TTATGGGATCT -> TATGGGATCTC
TTATTCGTGCG -> TATTCGTGCGG
TTATTGTAGGC -> TATTGTAGGCC
TTATTTTGACA -> TATTTTGACAT
TTCAAATCTGC -> TCAAATCTGCA
TTCAAGCTCTC -> TCAAGCTCTCT
TTCAATCATTG -> TCAATCATTGC
TTCACGACCCC -> TCACGACCCCA
TTCACTCTAAC -> TCACTCTAACC
TTCACTTGAAA -> TCACTTGAAAT
TTCAGCCGCAT -> TCAGCCGCATG
TTCAGCTTTGT -> TCAGCTTTGTC
TTCAGTAACGA -> TCAGTAACGAT
TTCATCACGCT -> TCATCACGCTA
TTCATCTACAA -> TCATCTACAAG
TTCATGATGCC -> TCATGATGCCG
TTCATGCAGAA -> TCATGCAGAAC
TTCATTCCGGC -> TCATTCCGGCA
TTCATTCTGGT -> TCATTCTGGTC
TTCCATTCAGT -> TCCATTCAGTA
TTCCCAGCAAT -> TCCCAGCAATA
TTCCGACATTC -> TCCGACATTCG
TTCCGCTAGAG -> TCCGCTAGAGT
TTCCGGCAGAA -> TCCGGCAGAAA
TTCCGGCGGGG -> TCCGGCGGGGC
TTCCGTTCGGG -> TCCGTTCGGGA
TTCCTCAGCTC -> TCCTCAGCTCG
TTCCTTTGGGG -> TCCTTTGGGGA
TTCGCTAGTGA -> TCGCTAGTGAC
TTCGGGATAGG -> TCGGGATAGGG
TTCGGGCTGGA -> TCGGGCTGGAA
TTCGGTCCGCT -> TCGGTCCGCTT
TTCGTGCGGAC -> TCGTGCGGACG
TTCGTTCATCT -> TCGTTCATCTA
TTCGTTGTAAT -> TCGTTGTAATC
TTCTATCGGAC -> TCTATCGGACT
TTCTCACTAGA -> TCTCACTAGAC
TTCTCGGAACT -> TCTCGGAACTG
TTCTGGATACT -> TCTGGATACTG
TTCTGGTCAGT -> TCTGGTCAGTG
TTCTTTTAGAC -> TCTTTTAGACT
TTGAAATGTAC -> TGAAATGTACC
TTGAAATTTCA -> TGAAATTTCAA
TTGACATTTTC -> TGACATTTTCA
TTGACCCACAT -> TGACCCACATT
TTGACTCGGTA -> TGACTCGGTAG
TTGAGATAATT -> TGAGATAATTT
TTGAGCCCCGT -> TGAGCCCCGTG
TTGAGTAGGAC -> TGAGTAGGACC
TTGAGTTCAGC -> TGAGTTCAGCT
TTGATAATCGG -> TGATAATCGGC
TTGATCCAAAG -> TGATCCAAAGT
TTGATGCAGTT -> TGATGCAGTTC
TTGCCAATTCA -> TGCCAATTCAT
TTGCCCGCCGT -> TGCCCGCCGTA
TTGCGTGGCCG -> TGCGTGGCCGA
TTGCTACAACA -> TGCTACAACAC
TTGGAATGTCT -> TGGAATGTCTC
TTGGACCTTAA -> TGGACCTTAAG
TTGGCACGTCT -> TGGCACGTCTT
TTGGGCTACCT -> TGGGCTACCTC
TTGGGGAAGAA -> TGGGGAAGAAA
TTGGTAGACGA -> TGGTAGACGAC
TTGGTCTAGAG -> TGGTCTAGAGT
TTGTAAAACGG -> TGTAAAACGGC
TTGTAATCCCG -> TGTAATCCCGT
TTGTACCTTTA -> TGTACCTTTAC
TTGTAGGCCGG -> TGTAGGCCGGG
TTGTCTCAAGT -> TGTCTCAAGTA
TTGTCTCACTT -> TGTCTCACTTG
TTGTCTCCCTG -> TGTCTCCCTGC
TTGTGAGCGTA -> TGTGAGCGTAC
TTGTGCAGGCG -> TGTGCAGGCGT
TTGTGGCGACG -> TGTGGCGACGC
TTGTTGGCACG -> TGTTGGCACGT
TTGTTTTATAA -> TGTTTTATAAG
TTTAAGCGTTC -> TTAAGCGTTCC
TTTACGTCGTA -> TTACGTCGTAG
TTTAGACTATT -> TTAGACTATTT
TTTAGCCCAGC -> TTAGCCCAGCC
TTTAGCCCAGT -> TTAGCCCAGTG
TTTATAAGTAT -> TTATAAGTATA
TTTCAAGCTCT -> TTCAAGCTCTC
TTTCAATCATT -> TTCAATCATTG
TTTCACTTGAA -> TTCACTTGAAA
TTTCATGATGC -> TTCATGATGCC
TTTCCTCAGCT -> TTCCTCAGCTC
TTTCCTTTGGG -> TTCCTTTGGGG
TTTCGGTCCGC -> TTCGGTCCGCT
TTTCGTTCATC -> TTCGTTCATCT
TTTCTATCGGA -> TTCTATCGGAC
TTTCTGGATAC -> TTCTGGATACT
TTTCTTTTAGA -> TTCTTTTAGAC
TTTGACATTTT -> TTGACATTTTC
TTTGACCCACA -> TTGACCCACAT
TTTGACTCGGT -> TTGACTCGGTA
TTTGAGTAGGA -> TTGAGTAGGAC
TTTGATGCAGT -> TTGATGCAGTT
TTTGCCAATTC -> TTGCCAATTCA
TTTGCCCGCCG -> TTGCCCGCCGT
TTTGCTACAAC -> TTGCTACAACA
TTTGGGGAAGA -> TTGGGGAAGAA
TTTGTCTCCCT -> TTGTCTCCCTG
TTTGTGAGCGT -> TTGTGAGCGTA
TTTTAGACTAT -> TTTAGACTATT
TTTTATAAGTA -> TTTATAAGTAT
TTTTCAAGCTC -> TTTCAAGCTCT
TTTTCGTTCAT -> TTTCGTTCATC
TTTTCTGGATA -> TTTCTGGATAC
TTTTGACATTT -> TTTGACATTTT
TTTTGCCAATT -> TTTGCCAATTC
TTTTGCCCGCC -> TTTGCCCGCCG
TTTTGTGAGCG -> TTTGTGAGCGT
